Name,Mon,Tue,Wed,Thu,Fri,Sat,Sun,Total
Bengal Cuisine,2119,1914,1641,1692,1533,1368,1869,12136
Duck & Waffle,986,1093,1215,1293,1358,1490,1368,8803
VQ Aldgate,980,922,1159,1264,1305,1417,1209,8256
Polo 24 Hour Bar,928,800,880,1001,1166,1568,1453,7796
Empire Casino,926,854,923,949,1101,1273,1244,7270
Cafe Diana,841,1002,1036,1023,1033,1123,1093,7151
"Balans Soho, No.60",753,826,1008,1019,1055,1403,1075,7139
Annabel's,743,1003,1139,1308,1254,1023,649,7119
KeyNest Edgware Rd - Station Food & Wine,1144,1112,739,979,852,985,1170,6981
Colbert,835,907,918,1175,1098,1065,949,6947
Brasserie of Light,1023,973,1028,1040,974,970,914,6922
The Ivy Cafe Marylebone,923,924,999,1033,1162,1037,750,6828
The Arts Club,758,950,1052,1178,1153,1025,700,6816
George,829,1210,1116,1194,1150,954,358,6811
The Ivy Kensington Brasserie,879,1020,846,997,1053,1017,984,6796
The Hippodrome Casino London,803,803,875,938,1021,1179,1050,6669
The Ivy Chelsea Garden,832,802,945,935,966,1090,1000,6570
Darwin Brasserie,806,771,806,828,1102,1094,1085,6492
Harry's Dolce Vita,843,980,941,1062,937,872,848,6483
The Barrel Vault - JD Wetherspoon,671,782,839,938,1159,1195,875,6459
Granary Square Brasserie,661,855,863,978,1038,1072,978,6445
The Ivy City Garden,766,958,1130,1290,1067,861,361,6433
The Poker Room,1028,658,835,851,948,1102,999,6421
sketch,560,641,976,991,1207,1192,799,6366
The Willow Walk - JD Wetherspoon,636,731,944,950,1085,1118,901,6365
Oriental Club,647,1090,1433,1333,1107,527,218,6355
JJ Moon's,772,811,845,962,992,1050,901,6333
Maison François,823,1181,1162,1200,1063,868,23,6320
The Ivy Cafe Wimbledon Village,836,706,856,844,1016,1004,1033,6295
"Caravan Fitzrovia | Outdoor Dining, Takeaway & Coffee",638,945,1026,1021,1001,1041,588,6260
The Good Intent,643,754,757,805,1006,1137,1129,6231
Sakaya at Pantechnicon,653,803,926,1054,1001,1056,716,6209
My Place Soho,681,666,797,1008,986,1114,947,6199
Oneills Euston Road,572,627,748,833,1021,1286,1087,6174
The Holland Tringham,853,758,765,876,1048,985,847,6132
Novikov Restaurant & Bar,718,818,825,931,912,997,797,5998
German Gymnasium Grand Café,658,724,877,963,952,1040,731,5945
Shakespeare's Head,611,648,808,914,1026,1161,774,5942
The Ivy Asia St Paul's,777,871,910,902,859,841,766,5926
The Ivy Soho Brasserie,815,850,894,1045,1090,1075,100,5869
The Ivy,666,818,901,972,930,907,673,5867
Scott's,814,844,941,867,821,791,757,5835
The Groucho Club,694,809,1109,1184,1130,766,138,5830
Riding House Café,646,852,860,982,912,937,602,5791
The William Morris,667,717,823,815,980,1009,779,5790
Home House,597,734,829,892,966,1080,689,5787
The Kentish Drovers,748,748,832,857,1044,863,677,5769
Kettner's Studio,602,695,873,966,996,932,701,5765
The Moon Under Water,707,660,798,845,870,998,855,5733
The Orange Public House & Hotel Victoria,493,1161,869,991,831,870,494,5709
Noura Delicatessen,713,877,998,613,906,802,759,5668
Forty Five Kensington,871,748,812,775,824,774,847,5651
The Central Bar - JD Wetherspoon,687,714,753,735,883,987,880,5639
The Ivy Victoria,569,788,733,935,920,951,743,5639
Harry's Bar,733,759,754,822,835,925,802,5630
Wetherspoon Free House,567,620,764,865,950,1119,745,5630
34 Mayfair,754,657,876,915,832,861,713,5608
67 Pall Mall,681,1068,1104,1152,1060,503,34,5602
OTHERWORLD VR,688,655,641,697,1029,990,897,5597
Wetherspoons (Victoria Station),604,641,759,816,913,1042,795,5570
Number One Church Street,706,873,750,908,940,647,744,5568
Sky Garden,625,734,769,861,862,813,887,5551
The Alfred Tennyson Pub Belgravia,499,776,835,974,898,812,718,5512
Daphne's,684,828,926,860,746,721,739,5504
Mildreds King's Cross,729,775,821,792,685,890,801,5493
The Ivy Canary Wharf,668,624,727,753,834,1000,865,5471
2 Bridge Place,522,662,1001,935,764,943,627,5454
The Ivy Asia Chelsea,674,757,731,830,808,769,851,5420
The Liberty Bounds - JD Wetherspoon,496,622,574,734,954,1147,871,5398
J Sheekey,707,656,761,825,886,875,658,5368
OTHERWORLD VR | Victoria,722,719,706,752,781,892,774,5346
"Caravan King's Cross | Outdoor Dining, Takeaway & Coffee",713,732,715,786,749,853,775,5323
Smith's Bar & Grill,587,814,975,1053,735,528,619,5311
All Bar One Regent Street,558,599,630,861,839,1040,771,5298
COYA Mayfair,674,696,794,992,834,701,584,5275
Travellers Tavern,593,466,547,666,918,1031,1035,5256
Les Ambassadeurs Casino,811,850,1044,1013,968,482,87,5255
ARC Le Salon,729,618,712,865,706,916,708,5254
Cote - Kensington,627,606,870,621,780,838,911,5253
Slug & Lettuce Tower Bridge,417,654,681,927,1023,1051,487,5240
Sofra,737,708,735,755,747,840,704,5226
Franco's,792,994,942,1040,883,575,0,5226
Brasserie Max,519,676,781,919,835,841,633,5204
Millie's Lounge,519,559,836,955,881,684,768,5202
"The Signal Box, Euston",801,525,688,862,1000,754,569,5199
Mile End American Pool & Snooker,665,727,789,709,732,797,729,5148
ROKA Mayfair,731,702,827,837,823,572,652,5144
The Stanhope Arms,567,635,717,747,859,975,617,5117
Bluebird,426,545,697,816,856,1100,676,5116
Merkato,764,649,717,751,896,674,660,5111
Canova Hall,516,570,617,752,802,1015,838,5110
The Ivy St. John's Wood,669,668,721,627,737,787,900,5109
Cacciari's Restaurant,556,616,616,888,889,837,675,5077
Kitchen at Holmes,516,736,784,738,878,797,622,5071
"The Mad Bishop & Bear, Paddington",517,593,729,708,946,754,820,5067
The London and South Western,494,579,685,691,951,1017,648,5065
Chapter Coffee Roasters,696,726,556,784,965,817,520,5064
Flight Club Bloomsbury,555,664,590,753,908,992,595,5057
Franklin's Wine,556,503,977,757,839,905,505,5042
The Gate Clock - JD Wetherspoon,658,544,613,686,817,995,729,5042
Cote - Sloane Square,502,689,742,743,691,899,771,5037
Plate Restaurant,688,770,913,817,824,675,345,5032
"Caravan City | Outdoor Dining, Takeaway & Coffee",563,717,917,1011,662,748,408,5026
Aviary - Rooftop Restaurant & Terrace Bar,459,619,766,791,902,911,568,5016
Lamb & Flag,600,668,644,738,834,875,650,5009
CasaCosta Italian Shop with Speakeasy Restaurant,740,670,682,712,979,761,462,5006
Cote - Barbican,688,653,728,730,634,882,683,4998
31 below,514,579,592,826,856,916,713,4996
The Alchemist St Martins Lane,553,522,609,717,875,998,720,4994
Cafe Brera,672,667,721,749,662,776,743,4990
28-50 Wine Workshop & Kitchen,614,710,706,826,869,851,405,4981
Spread Eagle,548,666,636,738,826,917,646,4977
Stanley's,541,752,742,836,721,829,537,4958
Gordon Ramsay Bar & Grill,609,570,658,747,882,917,574,4957
O'Neills Great Marlborough Street,438,481,596,763,950,962,760,4950
Pedley Street Station,0,720,753,781,974,837,877,4942
Flight Club Shoreditch,545,624,657,791,848,959,517,4941
All Bar One Covent Garden,526,497,556,784,793,1030,753,4939
Lina Stores King's Cross,588,685,702,855,744,778,584,4936
Isabel Mayfair,496,698,836,992,959,812,137,4930
The Pommelers Rest - JD Wetherspoon,424,542,646,647,794,1155,719,4927
Ajd Wetherspoon Free House,510,586,688,683,743,992,714,4916
The Nickel Bar,551,655,763,823,820,810,492,4914
The Library Bar,551,655,763,823,820,810,492,4914
Giraffe,572,543,544,647,736,1040,831,4913
Billionaire lounge,563,977,804,676,872,478,534,4904
"Caravan Bankside | Outdoor Dining, Takeaway & Coffee",569,645,761,853,683,846,544,4901
The Botanist Sloane Square,425,676,574,699,875,1064,568,4881
Apadana Persian Restaurant مطعم ابادانا الإيراني,622,662,803,667,886,634,605,4879
1 Lombard Street,716,927,973,1019,890,338,0,4863
The Grazing Goat Marylebone,375,579,636,741,825,898,807,4861
It's All Greek to Me,533,652,657,724,648,824,812,4850
Slug & Lettuce Hanover Street,418,517,753,734,926,1027,445,4820
S L B Bar,628,711,554,637,575,922,785,4812
Paxtons Head,417,534,595,673,824,950,816,4809
Flight Club,476,569,639,676,815,1015,617,4807
Grind,483,605,787,830,803,856,442,4806
Natural Kitchen,723,832,788,897,611,458,496,4805
The Alchemist Bevis Marks,467,576,618,801,848,1030,457,4797
Aqua Shard,548,568,589,712,822,825,717,4781
MEATliquor W1,545,521,607,707,700,988,700,4768
The Cyclist,498,448,630,594,790,1070,737,4767
The London & Rye,570,574,642,679,892,750,649,4756
Notes Coffee Roasters & Bar,534,561,776,877,738,696,572,4754
The Beehive - JD Wetherspoon,507,495,588,636,850,980,698,4754
Casa Tua Camden,586,463,650,740,740,910,662,4751
Coco Momo Kensington,433,587,559,762,793,868,738,4740
Disrepute,397,600,630,766,851,866,623,4733
Joiners Arms,440,459,559,565,865,1061,780,4729
Earl Of Derby,619,651,818,718,706,730,482,4724
The Cedar,620,551,696,591,668,742,854,4722
East Dulwich Picturehouse & Cafe,709,562,620,564,579,869,818,4721
The Masque Haunt,482,551,638,781,936,812,503,4703
Eight Members Club Moorgate,776,905,1027,1220,732,35,0,4695
Scootercaffe,460,504,700,646,702,1046,635,4693
Fox & Anchor Pub,497,481,734,793,837,762,586,4690
Gordon's Wine Bar,596,571,681,652,773,871,539,4683
Brasserie Blanc,454,648,734,696,727,853,571,4683
Park Lane Club,700,552,551,710,717,714,738,4682
The Brockley Barge,513,527,636,678,861,827,636,4678
The Happenstance,472,801,909,964,809,627,95,4677
Cote - Wimbledon,515,526,584,694,718,812,826,4675
Laki Kane Cocktail Bar & Thai Restaurant Islington,442,364,464,457,723,1164,1060,4674
Tony's Pita Swiss Cottage,531,640,584,661,763,675,819,4673
The Waterway,510,609,499,630,730,948,735,4661
Curzon Victoria,584,554,622,601,645,815,837,4658
Chapter 72,486,506,656,714,741,936,614,4653
The Thomas Cubitt Pub Belgravia,508,592,716,832,739,680,584,4651
Motcombs,616,734,814,790,528,594,570,4646
The Sterling in the Gherkin,631,833,987,1072,688,278,155,4644
Drunch,591,435,460,747,610,840,957,4640
Nags Head Peckham,499,473,624,630,831,889,692,4638
Radish Events,555,714,842,745,773,570,435,4634
Mthr,516,333,426,630,774,1034,918,4631
"The Churchill Arms, Kensington",571,572,616,652,743,856,616,4626
Curzon Mayfair,549,712,671,623,586,778,702,4621
Flight Club Victoria,437,600,681,696,792,859,541,4606
Balans West,654,539,531,671,714,951,545,4605
Hoop & Toy,474,453,686,708,792,890,595,4598
Ognisko Restaurant,542,545,532,714,692,826,738,4589
The Bull,557,526,588,654,765,814,679,4583
"The Red Lion, Parliament Street",539,648,742,740,679,720,515,4583
The Buxton,274,534,588,771,940,912,560,4579
Bar Termini,520,557,598,616,791,863,625,4570
Heddon Street Kitchen,515,610,817,915,877,126,702,4562
The Fox and Pheasant,332,540,609,657,688,883,852,4561
Refuel Bar & Restaurant,418,578,777,911,697,691,488,4560
Oscar Bar & Restaurant,432,557,678,584,800,833,674,4558
The Capitol - JD Wetherspoon,525,564,580,603,902,824,556,4554
Tuttons,488,515,650,667,652,856,725,4553
The Oyster Rooms - JD Wetherspoon,495,559,736,696,717,712,633,4548
The Parsons Green Sports & Social Club,746,793,608,758,564,488,588,4545
Dumplings' Legend,455,500,474,550,686,1059,814,4538
Cote - Covent Garden,485,665,612,573,935,735,529,4534
The Lighterman,402,474,590,714,743,906,702,4531
The East Hill,426,496,563,640,853,733,814,4525
The Garrison,453,578,705,575,748,778,682,4519
Duke on the Green,407,579,522,605,829,856,719,4517
The Moretown Belle,295,476,595,723,772,843,809,4513
The White Swan - JD Wetherspoon,492,559,618,630,831,875,507,4512
Courtfield,413,521,593,569,785,943,687,4511
Dirty Bones Soho,488,627,607,736,693,790,568,4509
The Bunch Of Grapes,530,545,608,558,754,881,623,4499
The Ice Wharf,431,462,477,538,778,1119,692,4497
Butlers Wharf Chop House,408,601,588,719,678,820,678,4492
The Metropolitan Bar,426,506,586,668,895,869,540,4490
"The Star Tavern, Belgravia",564,546,589,606,758,799,627,4489
Fox on the Hill - JD Wetherspoon,449,556,528,621,901,858,576,4489
Globe,383,509,640,723,812,859,560,4486
The Elephants Head,483,430,616,490,720,981,758,4478
Clean Heart Coffee & Organics,482,648,749,797,665,634,500,4475
Steam Passage,396,397,564,532,826,1021,735,4471
Little Crown,564,581,615,648,871,771,418,4468
Sofra Restaurant Mayfair,553,239,848,915,531,440,937,4463
The Camden Eye,399,374,542,605,713,1063,764,4460
Old Swan,358,430,546,635,775,1069,644,4457
The Alma,445,523,622,641,937,740,547,4455
Cote - Soho,444,441,624,694,684,858,705,4450
Craven Gardens Bar,619,753,563,681,553,789,490,4448
Comptoir Cafe & Wine,0,812,880,1025,781,950,0,4448
Mortimer House Kitchen,511,913,937,973,616,498,0,4448
The Salisbury Pub,474,433,534,577,740,1019,671,4448
The Phene,418,515,588,689,744,865,627,4446
Beluga Persian Grill & Bar,339,586,639,562,683,831,804,4444
Greyhound,414,659,801,1010,809,521,227,4441
No 32 The Old Town,441,459,441,531,731,1064,770,4437
M Victoria Street,413,708,638,1026,830,819,0,4434
Molly Blooms,516,570,558,661,631,883,612,4431
LSQ Rooftop - Leicester Square,524,479,703,694,606,1005,415,4426
Blacks Club,580,706,750,785,823,781,0,4425
Millers,383,595,565,696,757,804,624,4424
Court Tottenham Ct Rd London,408,487,576,672,860,739,681,4423
Shakespeares Head,463,533,529,552,713,953,678,4421
Fitzrovia Belle,434,623,659,740,872,545,545,4418
Burger & Lobster Mayfair,536,494,604,698,765,740,577,4414
Goodman's Field - JD Wetherspoon,472,473,522,618,881,897,551,4414
Burger & Lobster - Bond Street,578,539,529,638,705,732,691,4412
Draughts - Waterloo,413,455,566,578,597,1040,763,4412
Rose & Crown,595,538,432,762,753,737,592,4409
Estrela Bar,606,0,606,553,772,1092,777,4406
Laryn Cafe Bar,570,431,551,579,757,945,572,4405
Canton Element,555,613,545,639,714,743,591,4400
Dehesa,532,567,658,615,712,712,603,4399
Bocca di Lupo,584,724,713,633,700,520,525,4399
Burger & Lobster Knightsbridge,570,511,564,585,653,871,637,4391
Cote - St Christopher's Place,431,538,649,569,710,759,732,4388
Henry's Cafe Bar Piccadilly,429,538,646,719,856,785,414,4387
The Builders Arms,444,464,555,634,876,809,602,4384
COYA City,0,884,847,988,816,847,0,4382
By the Bridge Cafe,548,494,417,685,651,887,692,4374
The Black Cab Coffee Co,531,603,607,568,583,820,654,4366
José,510,529,710,719,657,696,544,4365
Big Easy Bar BQ & Crabshack,366,402,604,654,719,910,709,4364
"The Victoria, Paddington",431,487,572,655,762,752,700,4359
No 11 Pimlico Road,308,443,563,861,572,987,625,4359
Phoenix Chelsea,438,507,536,686,641,805,743,4356
Browns Covent Garden,262,552,651,656,724,948,561,4354
Hutong,450,526,677,634,654,693,719,4353
The shard,450,526,677,634,654,693,719,4353
Curzon Wimbledon,476,481,657,506,610,884,735,4349
The Gate Marylebone,552,493,574,645,706,838,541,4349
1751 Distillery Bar & Kitchen,466,537,615,716,643,906,463,4346
Selfridges,612,587,604,646,625,758,507,4339
Forty Dean Street,443,635,618,732,724,666,520,4338
Belushi's Shepherd's Bush,501,494,553,671,762,693,659,4333
M Threadneedle Street,355,697,877,1099,756,522,27,4333
The Rockingham Arms,519,535,526,571,870,815,495,4331
Bella Italia - St Martins Lane,530,483,569,546,640,792,764,4324
The Northumberland Arms,429,696,594,731,766,678,424,4318
The Plough,459,532,518,659,780,846,523,4317
The Sir John Oldcastle,337,560,655,865,959,668,267,4311
Kings Arms,368,474,670,784,770,664,579,4309
Bag O'Nails,343,536,555,607,710,912,645,4308
Poppies Fish & Chips,511,511,489,628,677,763,724,4303
London Snooker,669,533,549,587,558,667,739,4302
Nirvana Bar,616,596,404,520,732,760,668,4296
The Coach Makers Arms Pub Marylebone,359,468,564,804,784,833,484,4296
Ain't Nothin But The Blues Bar,483,458,527,606,595,898,729,4296
The Half Moon - JD Wetherspoon,511,506,619,658,828,682,488,4292
Bunch of Grapes,373,474,582,760,773,849,480,4291
Leicester Arms,369,441,578,703,702,992,495,4280
The Bloomsbury Club,490,486,454,566,744,982,558,4280
The Coral Room,490,486,454,566,744,982,558,4280
ROKA Charlotte Street,424,583,629,689,719,725,510,4279
Shochu Lounge,424,583,629,689,719,725,510,4279
Avanti West Coast First Class Lounge,847,500,495,681,819,334,601,4277
ROKA Canary Wharf,489,515,590,668,673,669,673,4277
MEATliquor Queensway,520,476,593,577,639,852,617,4274
Swingers Crazy Golf - West End,0,0,849,909,834,1006,674,4272
The French House,430,572,620,743,750,765,391,4271
Cubana Restaurant Waterloo,316,429,515,640,792,1048,531,4271
The Asparagus,475,442,529,571,842,808,603,4270
The Asparagus,475,442,529,571,842,808,603,4270
Mevali Shisha Bar,543,652,589,675,621,525,663,4268
Badger Badger,355,374,636,536,899,878,588,4266
Prince of Wales,359,518,517,625,773,854,618,4264
"The Old Bank, Battersea",303,422,608,596,738,969,628,4264
All Bar One Charing Cross,0,722,784,809,795,748,397,4255
Argyll Arms London W1,474,474,518,600,736,926,525,4253
Rising Sun,319,417,570,573,732,926,716,4253
Cote - St Martin's Lane,489,527,576,682,604,816,558,4252
Peckham Levels,383,462,489,519,824,1017,558,4252
PJ's Chelsea Brasserie,354,360,474,675,792,985,610,4250
Long Acre,391,428,551,585,727,1009,559,4250
The Grenadier,328,528,465,737,742,802,646,4248
QUEENS,514,476,555,540,571,907,683,4246
Leinster Arms,444,531,442,604,784,740,697,4242
The Hyde Bar at The Park Tower Knightsbridge,451,511,643,651,665,786,524,4231
Megan's Kings Road Restaurant (Chelsea),464,486,506,505,669,945,651,4226
Sawyers Arms,453,525,552,649,732,774,540,4225
Mildreds Camden,441,504,525,507,595,880,765,4217
Christopher's,0,570,649,765,783,1068,378,4213
Hans' Bar & Grill,540,455,667,642,551,834,521,4210
Engineer London Nw1,399,447,491,602,715,854,692,4200
Hornimans At Hays Tooley St,429,428,483,714,771,827,545,4197
Philglas & Swiggot,543,543,795,822,574,494,425,4196
Brockley Jack,442,570,572,646,808,715,441,4194
Bucks Head,345,360,385,498,717,1153,735,4193
"The Albert, Old Ford",448,507,547,477,788,818,604,4189
Brasserie Zédel,279,537,625,672,712,862,500,4187
Gallipoli Cafe & Bistro,354,444,502,557,724,864,741,4186
The Rosendale,413,419,505,491,689,908,759,4184
The Dugout at Belushi's Sports Bar,399,373,469,517,589,1041,796,4184
The Bolingbroke,364,350,599,619,716,827,707,4182
"The Harp, Covent Garden",356,516,691,672,776,883,284,4178
Greenberry Café,343,575,550,628,617,925,539,4177
The Founder's Arms,373,423,508,621,701,939,612,4177
Cafe Barca,485,485,504,536,773,964,429,4176
Kanishka by Atul Kochhar,508,583,625,673,701,532,554,4176
"The Hyde Restaurant, Bar & Hyde Garden",512,515,530,601,605,864,547,4174
Builders Arms Kensington,438,520,533,663,668,698,648,4168
Shakespeare,359,495,567,653,763,812,519,4168
Tuck Shop,0,711,727,782,728,709,511,4168
The American Bar,455,531,600,737,760,690,394,4167
The Grapes,615,503,431,539,657,763,659,4167
Cote - St Paul's,574,623,762,630,646,598,333,4166
The Spencer,558,457,550,479,672,729,720,4165
Duke of Kendal,459,429,422,676,721,755,703,4165
Boisdale of Belgravia,335,658,901,951,801,518,0,4164
Gazette Battersea,494,533,598,503,741,684,608,4161
Wahaca Covent Garden,469,457,600,566,581,784,702,4159
Marlborough Head,376,440,462,685,727,848,615,4153
The Good Mixer,396,427,494,586,733,943,570,4149
The Windsor Castle Pub,534,557,569,750,671,643,423,4147
MEATliquor East Dulwich,446,449,519,539,728,948,516,4145
Essenza Ristorante italiano,554,485,506,552,679,728,640,4144
The Parlour,408,583,717,919,770,533,214,4144
Flying Horse London W1,472,423,469,594,701,980,503,4142
Vinoteca King's Cross,391,455,637,631,616,824,586,4140
Enoteca,391,455,637,631,616,824,586,4140
Hazev Restaurant,430,471,518,701,706,674,634,4134
Southwark Tavern London Se1,359,502,580,730,793,799,370,4133
The Albert,404,448,581,749,674,751,525,4132
The Ivy Market Grill,441,434,516,630,610,860,640,4131
Bush Theatre,538,720,858,651,656,706,0,4129
Clachan Regent Street,391,501,505,682,694,855,500,4128
Fire Station,386,514,516,669,727,915,393,4120
The Clarence,384,504,571,687,659,867,447,4119
Montagu Pyke - JD Wetherspoon,436,445,483,534,735,924,559,4116
Browns Butlers Wharf,374,390,400,678,682,942,649,4115
The Black Dog,442,450,610,671,729,715,496,4113
Bedales of Borough Market,376,471,686,691,749,837,300,4110
All Bar One Holborn,370,422,581,740,653,900,440,4106
NOPI,548,492,726,670,852,817,0,4105
The Pig's Head,273,329,677,590,664,853,717,4103
Sherlock Holmes,377,449,445,634,687,950,557,4099
Milk Beach,0,589,687,608,700,896,618,4098
Flat Iron,420,523,575,617,613,810,540,4098
Mr Fogg's Residence & Secret Garden,284,413,557,689,874,935,345,4097
Horse & Guardsman,316,464,630,623,716,856,488,4093
The Jugged Hare,317,557,635,667,597,678,640,4091
New Fridays,487,431,494,480,624,902,672,4090
Crol and Co London Bridge,448,584,665,725,596,647,424,4089
Famous Cock Tavern,397,374,477,572,752,1025,491,4088
The Railway,320,423,492,516,819,833,683,4086
BrewDog Soho,366,478,560,654,746,891,390,4085
601 Queen's Rd,352,391,480,579,826,903,551,4082
Tapas Brindisa Soho,36,602,565,762,644,751,719,4079
The Rooftop,322,415,578,700,582,968,513,4078
Pappa Ciccia Fulham High Street,744,602,497,481,505,519,729,4077
The Morpeth Arms,500,546,622,782,607,554,466,4077
"The Surprise, Chelsea",412,423,624,605,557,942,512,4075
Red Dog Saloon - Soho Restaurant,429,537,503,524,756,721,602,4072
PIX Carnaby,448,543,602,682,689,741,363,4068
Camden Beer Hall,458,490,546,610,758,739,465,4066
Bar Liber,367,696,897,354,612,914,220,4060
Holborn Dining Room,275,503,570,691,697,795,522,4053
Fountains Abbey,458,550,511,538,732,721,533,4043
Change Please Coffee Elephant Park,644,619,630,613,624,510,394,4034
Bella Italia - Queensway 110,476,469,433,474,717,774,690,4033
Perfect Blend,562,421,473,608,605,818,545,4032
Windsor Castle Kensington,374,380,425,612,786,820,633,4030
The Running Horse,359,816,892,1034,658,261,10,4030
Giraffe,433,553,513,563,548,767,653,4030
Aqua Nueva,361,467,502,669,722,867,441,4029
The Real Greek - Westfield Stratford City,490,487,517,531,656,735,610,4026
The Boot & Flogger,403,541,691,664,735,737,252,4023
Mabel's Tavern,347,469,452,614,754,746,639,4021
Café Piazza,406,478,511,561,512,849,698,4015
The Wentworth Arms,381,360,556,637,553,822,704,4013
180 House,350,439,564,808,747,655,449,4012
All Bar One Waterloo,365,497,486,583,834,827,419,4011
Drake & Morgan at King's Cross,382,506,620,716,800,709,276,4009
Beaufort House Chelsea,236,332,445,572,715,1016,691,4007
"Casa Manolo, Chelsea",201,579,621,525,624,661,792,4003
Round Table,324,501,511,578,662,923,502,4001
The Bricklayers Arms,519,295,373,482,721,738,873,4001
Blue Posts,410,415,414,598,748,847,567,3999
Tapas Brindisa Battersea,184,713,710,400,715,625,651,3998
Vapourz Lounge | Vape Shop Tooting Broadway,687,710,468,700,633,389,410,3997
Polpo Soho,395,500,608,726,622,807,338,3996
Casa Blue,341,240,399,561,580,1040,834,3995
Kings Head,406,518,526,485,616,813,626,3990
The Wheatsheaf,348,492,585,681,757,785,342,3990
The Weatsheaf,348,492,585,681,757,785,342,3990
"The Swan, Hyde Park",334,490,511,493,691,814,656,3989
The Regent,319,334,460,527,560,924,862,3986
Wingmans,416,535,525,598,614,775,521,3984
Century Club | Private Members' Club Soho,0,750,840,897,795,630,71,3983
Westow House,392,387,488,558,733,754,667,3979
Elephant & Castle Kensington,432,627,559,686,554,700,420,3978
Albion,516,457,555,594,529,665,662,3978
BoysnBerry,520,532,472,521,518,711,700,3974
Casa Tua King's Cross,462,454,466,476,687,771,658,3974
The County Arms,319,386,552,658,661,774,623,3973
All Bar One New Oxford St Lond,347,491,461,585,739,936,414,3973
The Ship Tavern,357,435,581,701,658,714,527,3973
The Riverside,295,549,637,740,636,616,499,3972
Cock & Lion,478,600,489,605,677,692,429,3970
Sophie's Soho,364,394,468,649,768,888,439,3970
The Nott,396,545,531,520,737,614,624,3967
parlez,448,393,506,521,659,829,606,3962
The Shipwrights Arms,337,450,599,732,752,765,326,3961
The Lewisham Tavern,373,486,449,606,626,860,555,3955
Salt Yard,578,568,698,715,584,650,160,3953
Double Shot Covent Garden,0,476,601,695,733,915,529,3949
Five Bells,333,470,491,482,586,821,760,3943
Swingers Crazy Golf - City,0,0,693,870,824,1056,496,3939
The White Horse,641,689,602,591,747,667,0,3937
Electric Shuffle London Bridge,371,489,504,598,711,851,410,3934
"The Barrowboy & Banker, SE1",318,419,493,657,729,893,423,3932
Alice House Queen's Park,418,410,414,483,681,961,564,3931
Kingpin Suite,421,456,436,620,802,477,714,3926
The Larrik,360,487,517,718,649,612,582,3925
The Abingdon,416,426,475,633,628,596,747,3921
The Gloucester Arms,280,433,473,581,758,691,704,3920
Scarpetta - Canary Wharf,426,637,694,592,536,557,477,3919
Genesis Cinema,572,449,588,604,516,625,560,3914
Champion Bayswater Road,417,538,506,618,595,643,596,3913
Electric Shuffle Canary Wharf,298,457,543,566,664,868,516,3912
Yamal Alsham,510,427,459,543,664,799,508,3910
The Dolphin,394,502,505,506,785,669,549,3910
The Alchemist Old Street,386,352,487,596,679,943,467,3910
Dirty Dicks,281,390,517,642,770,827,482,3909
Louie Louie,351,566,564,633,782,751,260,3907
Coach & Horses,498,486,496,596,612,864,353,3905
Koha Restaurant & Bar,429,525,561,715,575,696,403,3904
The Salt Whisky Bar and Dining Room,440,438,511,544,652,732,586,3903
Coopers Arms,337,425,556,679,538,805,559,3899
The Surrey Docks,436,416,448,521,757,775,546,3899
Massis,450,534,627,743,545,547,452,3898
Whirled Cinema,384,322,515,236,575,941,925,3898
The Refinery,377,508,607,829,629,668,279,3897
La Goccia Covent Garden,0,499,729,777,661,861,370,3897
The Beast of Brixton,187,261,321,506,908,1020,692,3895
Penderel's Oak - JD Wetherspoon,296,481,485,701,810,697,425,3895
Apero Restaurant & Bar,315,438,453,496,716,845,631,3894
Bar + Block Steakhouse Aldgate,439,482,513,603,566,687,604,3894
Lowlander Grand Cafe,375,406,603,581,635,835,457,3892
Goat Tavern,360,416,414,507,742,883,566,3888
Cafe Murano St James,535,511,625,727,616,873,0,3887
Old George Bethnal Green,273,287,568,502,714,894,649,3887
"The Antelope, Belgravia",438,456,606,669,734,754,229,3886
Caldesi In Marylebone - Italian Restaurant,548,550,605,604,609,721,246,3883
Cafe Pacifico,294,352,456,606,658,903,612,3881
Hard Rock Cafe,468,456,466,508,577,806,598,3879
The Knights Templar,501,525,637,839,927,448,0,3877
Junkyard Golf Club Worship Street,280,345,444,657,747,960,444,3877
Pig & Whistle,342,426,638,502,742,633,592,3875
Haozhan,487,459,360,589,585,806,587,3873
The Ring,371,455,638,735,698,687,289,3873
Queens Arms,371,392,531,710,673,576,618,3871
The Blue Posts,384,545,503,781,695,625,336,3869
Noble Rot Lamb's Conduit,520,638,676,792,621,620,0,3867
Hand in Hand,440,445,427,442,556,801,755,3866
Wright Brothers Battersea,341,388,396,511,651,931,648,3866
The Exmouth Arms,204,366,578,721,790,844,362,3865
Ciro's Pizza Pomodoro -Italian Restaurant & Bar,547,527,429,514,592,659,596,3864
Hope Smithfield,384,454,647,672,627,683,396,3863
The Dartmouth Arms,381,385,515,531,746,776,527,3861
Mario's,457,481,557,527,570,897,372,3861
Ishbilia Lebanese Restaurant,490,479,497,498,534,708,652,3858
The Boathouse,356,444,398,457,754,871,577,3857
The Devonshire Arms,471,525,481,621,642,650,467,3857
Gazette Trinity,484,400,555,645,667,710,388,3849
Chelsea Ram,317,477,516,470,598,859,611,3848
Sports Bar & Grill Old Street,229,390,523,559,540,919,686,3846
The Green Room,384,455,543,641,541,879,401,3844
Martina London,392,489,512,538,740,676,496,3843
The Royal Oak,211,472,591,557,666,708,638,3843
Lord Wargrave,339,442,512,644,632,711,560,3840
Angie's Free House,447,357,361,363,788,820,701,3837
Palm Court Brasserie,485,378,502,572,604,756,539,3836
Mrs Riot,276,278,491,568,748,831,644,3836
Tower Bridge Arms,268,379,452,637,713,865,520,3834
No 35 Mackenzie Walk,367,583,339,696,723,791,333,3832
The Real Greek - Spitalfields,367,412,538,652,576,728,558,3831
Kerridge's Bar & Grill,390,548,586,570,599,718,414,3825
Zetland Arms,354,440,497,590,672,763,508,3824
The Royal Oak,568,360,505,400,666,776,547,3822
The Empress,257,371,508,559,663,744,720,3822
The Duke of York,360,437,580,666,790,580,408,3821
"The Admiralty, Trafalgar Square",393,405,505,576,612,878,451,3820
The Ten Bells,287,408,452,680,770,760,456,3813
BrewDog Canary Wharf,386,510,704,726,595,524,367,3812
Glassblower,348,421,516,646,631,766,483,3811
Flesh & Buns Oxford Circus,384,512,542,668,605,759,339,3809
The Honor Oak Pub,394,273,449,566,705,733,683,3803
BRAT Restaurant,476,507,580,516,564,603,554,3800
Fox & Hounds,273,378,486,469,703,897,591,3797
The Prince of Teck,409,492,558,491,637,593,617,3797
Eldr Roof Garden at Pantechnicon,146,394,468,466,765,984,573,3796
Market Hall Fulham,363,464,633,435,522,751,625,3793
The Bedford,285,344,406,459,667,952,680,3793
All Bar One Leicester Square,316,412,451,567,742,902,403,3793
Lokkanta,448,567,489,494,553,723,515,3789
The Bow Bells,514,396,460,464,729,654,572,3789
The Chelsea Pig,0,238,765,685,684,715,701,3788
The Dog & Bell,370,310,491,431,599,902,685,3788
The Hand in Hand,312,381,440,486,620,809,738,3786
Le Garrick,504,524,571,710,670,807,0,3786
The Painter's Room,335,497,611,717,607,611,401,3779
Duchess Belle,234,374,523,703,924,721,300,3779
"The Round House, Covent Garden",315,448,464,544,659,896,453,3779
The Red Lion,435,435,506,470,651,627,655,3779
Swift Soho,451,513,538,574,602,703,393,3774
Crown & Sceptre,390,398,380,446,781,786,592,3773
George,341,449,494,720,670,784,314,3772
The Northumberland Arms,304,374,529,601,808,712,437,3765
"The Bridge Tap, London",265,383,441,623,693,882,477,3764
Duke of Wellington,319,544,558,751,717,609,264,3762
The Pig and Butcher,365,349,366,496,686,708,792,3762
Town of Ramsgate,467,370,470,541,549,765,598,3760
Tir na Nog,264,452,356,352,623,1004,708,3759
Papa-dum Street Kitchen,0,636,757,582,534,641,609,3759
The Marquis of Cornwallis,349,343,402,457,749,765,694,3759
Busaba Bloomsbury,384,591,610,621,576,628,346,3756
The Hare,311,384,431,454,751,871,554,3756
Sourced Market - St Pancras,336,697,585,664,878,369,226,3755
Lord Nelson,335,531,351,457,821,770,488,3753
Baxter’s Court,444,384,498,609,734,595,489,3753
Queens of Mayfair,419,495,640,598,533,574,494,3753
St Stephen's Tavern,452,449,490,524,583,724,529,3751
The Seven Stars,330,454,577,720,648,678,342,3749
Hope Upper Tooting,330,230,498,455,699,944,591,3747
The Hive,521,665,621,556,454,517,410,3744
Sabine Rooftop Bar,244,379,432,549,694,866,579,3743
Amber Restaurant,175,420,423,591,583,873,677,3742
Wildwood,760,700,720,800,760,0,0,3740
Mulberry Bush,341,452,574,633,615,810,314,3739
The Old Fields,418,409,500,480,685,738,506,3736
Clays Bar,265,485,716,760,634,689,187,3736
Blacklock Shoreditch,500,424,503,563,559,621,566,3736
Ekte Nordic Kitchen,189,695,686,701,695,766,0,3732
The Coffee Room,539,504,456,616,449,541,627,3732
Pico Bar & Grill,372,373,487,630,701,673,494,3730
The Enterprise Bar & Hotel,307,346,364,536,579,950,642,3724
Doggetts Coat & Badge London,343,407,411,625,595,860,482,3723
The Eagle,403,421,352,627,766,653,497,3719
Brondes Age,383,436,390,485,690,727,605,3716
Brook House,0,314,563,712,726,786,614,3715
"The Union Tavern, Westbourne Park",327,482,402,638,826,627,412,3714
The Moniker,340,723,911,1148,592,0,0,3714
The Shepherd & Flock,484,493,421,499,560,605,651,3713
Maxwell's Bar & Grill,440,384,398,502,583,820,586,3713
Duchess of Kent,369,426,465,378,640,839,596,3713
The Lord Napier Star,0,279,431,521,668,1043,770,3712
The Alchemist Embassy Gardens,433,381,443,550,691,728,483,3709
The Jolly Farmers,593,413,471,358,764,654,452,3705
Davy's at Plantation Place,382,951,1040,831,500,0,0,3704
The Greyhound,422,299,318,434,728,832,670,3703
Bar + Block Steakhouse Kings Cross,400,426,517,516,663,634,546,3702
The Nightingale,285,369,544,502,561,755,685,3701
Hush Mayfair,401,518,574,718,657,831,0,3699
Mews Cocktail Bar,401,518,574,718,657,831,0,3699
The Manor Arms,287,311,410,543,620,843,684,3698
Crocker's Folly,417,401,521,559,592,723,484,3697
Over Under Earls Court,493,552,519,452,583,572,522,3693
Artigiano Espresso and Wine Bar,424,719,787,1116,647,0,0,3693
The Owl and Pussycat,267,347,515,571,715,835,443,3693
Rusty Bike Pub Mile End,312,422,429,505,576,883,564,3691
The Market Porter,370,491,607,683,661,585,291,3688
The Cider House,370,491,607,683,661,585,291,3688
Market Taverns Ltd,370,491,607,683,661,585,291,3688
aspen & meursault,0,432,599,542,591,758,764,3686
Three Crowns,327,444,577,698,609,624,407,3686
Notes Coffee Roasters & Bar,539,761,756,1007,622,0,0,3685
The Lyric,301,422,450,507,772,821,410,3683
The Pride of Spitalfields London,317,354,617,613,781,708,292,3682
Mikrus,221,586,405,487,459,777,742,3677
"Slug & Lettuce, St Mary Axe",235,402,548,774,743,759,216,3677
Plaquemine Lock,410,406,289,490,648,919,511,3673
Old Ship Hackney,347,372,389,500,747,766,550,3671
The Imperial,311,394,442,427,666,962,465,3667
Chelsea Potter,568,541,615,653,738,550,0,3665
Bellamy's,240,795,773,852,682,323,0,3665
All Star Lanes Brick Lane,307,399,513,639,605,764,436,3663
Beer + Burger Dalston,303,389,506,618,646,670,530,3662
Nata's Coffee Bar -Tooting,528,531,465,532,435,588,581,3660
Canterbury Arms,272,489,428,540,682,689,560,3660
"The Hereford Arms, South Kensington",227,453,479,603,598,707,587,3654
Johnnies Kitchen,426,531,459,540,624,548,526,3654
The White Hart,257,381,401,570,661,716,668,3654
The Elgin,283,318,425,485,714,914,512,3651
The Prince Alfred,339,384,398,486,712,694,637,3650
Falcon Clapham Junction Sw11,343,381,442,533,739,838,374,3650
The Lansdowne Pub & Dining Room,306,449,422,530,576,672,695,3650
Wellington London Wc2,352,381,455,532,573,865,491,3649
The Island,269,389,480,522,717,657,614,3648
The Water Rats,255,479,453,461,695,726,579,3648
The Brunel,307,385,478,431,683,826,538,3648
The Real Greek - Covent Garden,438,406,456,491,479,812,559,3641
Le Beaujolais,296,551,652,865,659,617,0,3640
Piccolino Heddon Street,279,358,503,511,657,811,519,3638
BrewDog Seven Dials,344,389,463,527,618,869,427,3637
The Britannia,377,435,353,588,706,634,542,3635
Ye Grapes,311,387,562,718,706,631,318,3633
Opera Tavern,405,506,533,757,551,880,0,3632
Market Hall,291,459,550,689,575,668,399,3631
Bread Street Kitchen & Bar - Southwark,279,410,579,719,662,721,261,3631
White Horse Newburgh St Soho W,310,383,475,668,627,754,412,3629
108 Brasserie,32,543,719,761,571,778,224,3628
Io 8 Bar,32,543,719,761,571,778,224,3628
Taste of India,407,490,466,391,570,656,647,3627
The Three Tuns,319,440,450,745,698,608,367,3627
Fairuz,267,609,662,604,539,640,306,3627
Burger & Lobster Bread Street,342,450,522,707,547,697,362,3627
The Oxford Arms,280,271,425,451,610,994,593,3624
Prince Albert Notting Hill Gat,335,367,371,482,726,831,511,3623
The Globe Tavern,233,361,454,622,644,908,400,3622
"Bonds, Mayfair",229,418,561,655,745,688,325,3621
Curzon Soho,427,371,417,438,510,823,634,3620
The Warwick Castle,326,336,571,493,674,737,481,3618
Sheephaven Bay,416,330,366,524,423,812,746,3617
The Cock Tavern,307,420,550,590,663,772,312,3614
The Anchor,401,409,375,494,719,737,478,3613
The Distillery Bar,349,494,427,562,654,670,455,3611
"The Mall Tavern, Notting Hill",228,355,501,688,752,634,452,3610
The Goat Chelsea,216,323,424,624,809,801,413,3610
"White Swan, Pimlico",392,334,487,613,646,614,522,3608
Porcupine Charing Cr Rd London,335,376,422,511,622,863,476,3605
Le Relais de Venise L'Entrecote - Marylebone,423,508,542,598,532,539,462,3604
Cable Bakery Bar and Pizzeria,0,604,524,591,566,686,632,3603
Gladstone Public House,332,447,469,341,709,734,571,3603
The Stags Head,194,463,541,627,730,522,525,3602
TGI Fridays - Leicester Square,347,402,420,429,673,774,556,3601
Amar Café Chelsea Green,532,591,710,738,529,233,267,3600
Kings Sports Bar at The Empire Casino,332,397,425,415,475,809,747,3600
The Crosse Keys,228,339,555,843,798,629,206,3598
temper Soho,176,468,541,596,714,801,302,3598
Chotto Matte London,272,373,442,542,715,911,343,3598
The Sun Tavern,322,356,387,450,666,716,700,3597
The Monkey Puzzle,421,413,349,493,651,756,509,3592
Coach & Horses,352,392,477,562,541,814,453,3591
Brasserie Blanc - Chancery Lane,433,613,607,848,659,431,0,3591
Cask Pub & Kitchen,185,494,512,741,634,595,429,3590
The Faber Fox,359,304,370,345,668,769,774,3589
Hop Pole,399,413,510,501,691,547,527,3588
The Coach,259,443,564,766,653,662,239,3586
The Warwick Pimlico GastroPub and Dining Room,372,459,555,620,658,466,455,3585
The King's Arms,325,224,495,586,640,749,566,3585
Traitors Gate,153,383,440,785,581,802,441,3585
Bella Italia - Queensway 55,411,275,344,428,606,805,715,3584
The Brown Cow,10,48,608,570,691,965,689,3581
The Rose,367,383,467,678,721,557,407,3580
Jinjuu Soho,316,441,489,541,693,815,285,3580
The Troubadour,285,347,406,473,660,805,603,3579
All Bar One Tower Of London,286,409,510,690,682,631,370,3578
Uva,425,471,596,636,984,330,136,3578
The Camel,253,399,463,492,650,813,505,3575
The Minories,247,322,421,645,671,828,437,3571
The Old Bell,322,399,440,428,776,740,465,3570
Prince Regent London W1,330,463,450,603,645,660,419,3570
Burdock,335,556,612,706,420,612,329,3570
The Victoria,301,360,357,462,633,861,594,3568
Ping Pong Soho,317,384,472,507,584,767,535,3566
Masala Zone Covent Garden,408,323,418,388,550,857,622,3566
The George,281,326,460,522,749,557,671,3566
Black Sheep Coffee & Cocktails,478,460,450,410,461,574,732,3565
The Arches,421,540,514,457,529,586,511,3558
Mitre Lancaster Gate,313,438,449,555,606,685,512,3558
Chez Antoinette Victoria,338,614,668,786,501,650,0,3557
All Bar One Picton Place Londo,240,364,543,642,684,665,416,3554
Albany Gt Portland St London,262,351,438,553,735,735,480,3554
Melanzana,467,341,444,440,587,602,671,3552
Morgan Arms,271,368,631,405,501,640,734,3550
The Selkirk SW17,251,363,405,441,700,778,611,3549
Privée by Layalina,422,424,184,444,614,810,646,3544
Layalina Knightsbridge,422,424,184,444,614,810,646,3544
Boulevard Brasserie,509,320,395,475,444,860,539,3542
The Terrace Bar,578,419,400,404,551,727,463,3542
Tattersalls Tavern,361,391,390,484,857,695,362,3540
The Blues Kitchen,334,312,408,401,538,867,680,3540
The George,355,322,354,342,738,946,483,3540
The Font Wandsworth,464,459,548,520,446,530,572,3539
The Guinea Grill,382,524,651,763,614,416,187,3537
The Albert,250,422,337,483,705,727,612,3536
The Alexandra,337,348,399,528,733,743,445,3533
Riverside Studios,542,455,597,666,385,475,411,3531
L'Escargot Restaurant,82,613,507,781,671,839,36,3529
Garden Rooftop,208,259,308,506,609,907,732,3529
Blue Posts,292,389,547,669,640,631,360,3528
East Dulwich Tavern,324,333,334,385,583,941,628,3528
Bar Soho,335,304,362,428,597,876,624,3526
Philomena's Irish Sports Bar & Kitchen,122,321,406,540,602,982,551,3524
Be At One Spitalfields,207,274,378,540,707,852,564,3522
Min Jiang,399,441,471,528,475,637,569,3520
The Marquis,365,315,503,639,633,766,299,3520
Maroush Earl's Court Road,376,444,411,436,432,733,687,3519
Paternoster Chop House,364,464,580,774,577,591,168,3518
Blue Boar,239,395,579,677,618,537,472,3517
Tap East,340,446,507,631,513,644,436,3517
Hispania,636,704,786,732,658,0,0,3516
The Spotted Horse,269,265,458,422,729,874,498,3515
The Hill,423,287,354,542,704,706,497,3513
Coppa Putney,416,498,543,560,365,473,657,3512
Seven Dials Market,363,365,482,532,562,849,359,3512
The Mantl,479,365,372,477,556,704,557,3510
The Eagle Farringdon,363,431,592,666,646,586,224,3508
All Bar One Butlers Wharf Lon,308,325,342,671,744,686,432,3508
The Lillie Langtry,147,328,428,536,702,924,442,3507
Tendido Cero,332,550,519,498,555,700,353,3507
"Casa Manolo, Clapham Junction",226,421,471,391,799,774,425,3507
Burger & Lobster Soho,325,342,396,524,646,794,479,3506
Blacklock City,465,491,544,608,485,603,310,3506
Fora,439,628,591,425,432,612,377,3504
Rose & Crown,222,400,425,556,787,740,374,3504
Rail House Café,294,453,587,612,460,683,415,3504
Ibérica,0,585,670,545,636,791,276,3503
White Horse London Sw6,234,366,417,529,701,772,483,3502
The Union Club,0,682,894,1051,873,0,0,3500
Duke of Cambridge,307,327,374,448,520,779,744,3499
The Signal Pub,286,253,425,318,604,891,722,3499
Ukai,297,253,359,363,636,969,619,3496
The Brown Bear,330,469,621,696,503,566,311,3496
Brumus Bar & Restaurant,355,460,407,643,489,821,320,3495
The Pilgrim Pub,317,348,392,570,731,611,526,3495
Wigmore Hall,570,490,502,568,452,410,500,3492
Old Coffee House,241,339,396,601,680,810,425,3492
"The Hung Drawn & Quartered, EC3",259,446,559,663,669,717,179,3492
New Street Grill,309,390,495,610,599,798,291,3492
The Coffee Room Deptford,556,579,503,494,523,351,485,3491
Prince Albert,325,334,378,409,676,817,551,3490
The Lodge Cafe.,444,378,403,423,414,711,717,3490
Curzon Aldgate,398,381,449,443,495,617,707,3490
Gong,261,28,352,551,689,779,829,3489
Haché Burgers Camden,307,391,377,549,416,840,607,3487
The Wine Place Covent Garden,418,410,407,420,493,759,580,3487
The White Hart,209,298,453,581,766,860,319,3486
Searcys at The Gherkin,421,373,499,682,741,514,251,3481
STK Steakhouse London - Strand,235,369,418,587,716,783,372,3480
The Blackfriar,315,438,585,648,702,792,0,3480
Park Chinois,242,288,500,567,586,790,506,3479
Bar Remo,342,378,588,590,545,702,334,3479
Ping Pong Shepherds Bush,398,409,389,434,509,777,562,3478
N1 Bar London,264,268,350,450,615,888,642,3477
MArks of Deptford,319,444,494,500,499,830,390,3476
Bella Cosa,428,363,402,411,395,803,674,3476
The Elephant and Castle Pub,297,396,404,462,664,750,501,3474
Cabotte,594,677,786,871,546,0,0,3474
The Hayden Pub & Rooms,294,424,378,343,580,758,696,3473
Larry's,317,0,728,960,565,547,356,3473
The Bird in Hand,334,378,400,351,682,707,620,3472
The Brookmill,136,333,441,525,587,764,686,3472
Temperance,407,376,391,430,623,795,449,3471
The Lillie Langtry,367,347,406,391,493,753,714,3471
The Arch Bar,431,447,345,412,593,803,439,3470
The Fellow,257,422,510,662,679,483,457,3470
The Folly,278,435,524,817,694,533,188,3469
JOAN,300,332,420,401,646,897,473,3469
The Queen Adelaide,190,268,500,422,697,773,618,3468
Hay's on the River,244,212,579,550,598,740,545,3468
McGettigan's Fulham,171,372,460,311,511,919,723,3467
The White Lion,382,404,363,354,716,668,578,3465
Black Sheep Coffee & Cocktails,463,519,601,565,474,392,451,3465
Grounds and Grapes,0,657,468,579,673,703,385,3465
Crusting Pipe,382,357,419,435,489,790,592,3464
Bow Street Tavern,261,249,429,649,608,897,371,3464
Arabica Borough Market,215,263,524,679,622,800,361,3464
The Orchard London,458,408,367,403,581,651,596,3464
Tempio Restaurant,401,661,775,986,640,0,0,3463
Commercial Tavern,215,419,446,606,628,744,405,3463
The Lost Hour,338,320,439,502,488,862,512,3461
The Conquering Hero,364,291,491,402,647,538,726,3459
The Palmerston,198,283,331,337,625,1019,666,3459
The Pembroke,152,359,442,554,604,796,550,3457
BrewDog Outpost Tower Hill,256,389,497,707,624,692,292,3457
HUŎ,351,380,457,563,688,590,427,3456
The Cross Keys,365,426,414,601,559,685,406,3456
Rake’s Café Bar,0,439,521,701,828,909,58,3456
Beach Blanket Babylon,301,281,454,421,657,884,456,3454
Bella Italia - South Kensington,345,257,333,484,531,819,684,3453
Windmill,289,419,555,725,694,567,204,3453
COCO RESTAURANT Grill & Lounge,338,336,377,415,520,763,704,3453
The Princess of Wales,257,315,327,486,621,839,606,3451
De Hems London,226,312,465,576,604,905,362,3450
The Hero of Maida,281,307,342,569,610,682,658,3449
The Althorp,413,304,316,499,544,752,620,3448
Gazette Putney,367,504,589,504,607,569,307,3447
Bella Italia - Paddington,326,466,343,483,480,816,532,3446
Christina's Shoreditch,348,275,358,589,684,862,329,3445
The Rose,139,294,661,462,450,686,752,3444
BrewDog Shoreditch,288,316,407,549,602,894,388,3444
The Five Bells,396,335,480,382,647,821,382,3443
The Pride Of Paddington,299,308,460,575,725,643,432,3442
The Restaurant at The Capital,348,460,539,679,622,794,0,3442
Mosimann's,0,701,689,824,841,386,0,3441
Bō KIRI,309,490,459,389,820,655,319,3441
The Fox & Hounds,317,413,474,637,552,623,423,3439
The Cavendish,326,290,457,634,646,617,467,3437
"The Doric Arch, Euston",336,384,530,540,555,581,511,3437
The Prince of Wales,225,298,464,409,757,731,553,3437
Sports Bar & Grill Victoria,225,424,467,478,420,705,716,3435
ROKA Aldwych,0,0,636,695,708,734,661,3434
Mandarin Bar,378,603,0,522,666,694,567,3430
Mr Fogg's Society of Exploration,0,0,495,584,688,1007,656,3430
Corrigan's Bar & Restaurant,0,250,742,872,892,672,0,3428
Touro,385,371,349,436,615,627,644,3427
Shades Sports Bar,594,501,535,456,428,493,419,3426
Wheatsheaf,225,271,357,421,703,782,666,3425
Joe Allen Restaurant,0,338,726,611,627,886,237,3425
The Union Tavern,228,522,511,745,728,688,1,3423
Angel In The Fields,363,402,528,551,633,587,358,3422
Brinkley's,215,234,530,724,620,636,460,3419
The Green Goose,397,226,263,553,615,739,626,3419
The Plough Clapham Junction,267,290,414,451,704,736,556,3418
Ladywell Tavern,358,361,439,455,694,650,460,3417
Rapsa @ 100 Hoxton,0,392,256,500,657,913,698,3416
L'Artiste Muscle,347,662,405,631,632,736,0,3413
The Queen's Head,236,371,466,525,580,860,375,3413
The Hemingford Arms,257,377,461,556,594,743,425,3413
The Winemakers Club,306,561,623,807,734,381,0,3412
Hop Burns & Black,0,442,488,530,656,820,476,3412
Volunteer Nw1,281,427,403,681,633,567,419,3411
"The King's Head, Earl's Court",274,380,523,524,590,590,529,3410
The Cross Keys,0,363,544,616,564,713,610,3410
Demartino,398,568,570,649,616,609,0,3410
Efes Restaurant,378,425,461,541,609,570,426,3410
Boom: Battle Bar Wandsworth,268,439,399,507,607,821,367,3408
Lord High Admiral,271,132,495,623,776,630,481,3408
Queen Victoria,351,539,371,451,841,589,265,3407
Swift Shoreditch,287,390,508,492,677,667,385,3406
Slug & Lettuce County Hall,327,316,449,515,717,700,381,3405
Martello Hall,205,282,292,419,650,994,562,3404
Black Cat,372,433,474,385,686,667,385,3402
Meson Don Felipe,352,536,620,595,612,686,0,3401
Sixes Cricket Club,0,0,492,485,586,1074,762,3399
Swan Hammersmith,357,339,397,546,663,687,409,3398
Brewhouse & Kitchen - Highbury,286,339,451,438,619,864,401,3398
Hawksmoor Borough,260,254,520,509,562,637,656,3398
Sultan Sofrasi,375,313,414,483,595,629,589,3398
"Casa Manolo, Putney",445,355,492,404,439,573,688,3396
Jin Bo Law,0,336,442,636,743,823,414,3394
One Tun,213,388,541,762,580,643,267,3394
The Old Bank,457,314,396,480,695,737,314,3393
Prince of Peckham Pub,271,326,309,391,554,886,655,3392
"Balans, Kensington",375,354,425,434,472,807,524,3391
The Hillgate,303,443,407,551,578,726,380,3388
Orrery,379,466,565,379,557,618,423,3387
Common,411,315,380,476,467,647,688,3384
The Crown and Shuttle,144,300,389,673,707,892,279,3384
Ping Pong St Katharine Docks,455,0,411,551,634,672,661,3384
"The Scarsdale Tavern, Kensington",293,401,456,614,592,522,505,3383
White Swan Covent Garden,250,251,395,477,651,859,500,3383
Aragon House,191,363,484,437,544,798,565,3382
Prince Albert,240,383,409,392,725,707,523,3379
Wahaca Canary Wharf,363,425,405,534,519,686,446,3378
"Puttshack, White City",270,285,340,469,607,913,492,3376
Churchills,309,353,423,395,677,832,387,3376
The Hunter's Moon,297,254,450,468,629,756,522,3376
Cocoro,428,306,398,527,513,557,647,3376
The Earl of Essex,318,317,388,502,571,795,485,3376
Princess Of Wales Charing X,291,260,344,536,622,834,488,3375
Giraffe,452,199,490,294,501,684,754,3374
Carbon Kopi,489,418,406,460,539,477,583,3372
The Eagle,361,364,357,431,514,822,522,3371
Goat Tavern,256,334,447,608,697,702,326,3370
The Duke of Richmond,199,175,339,342,646,842,826,3369
The Hansom Cab,248,342,489,531,589,554,614,3367
Rocket Euston Rd London Nw1,328,362,418,442,535,776,505,3366
Bounce,219,270,409,534,654,931,349,3366
SuperStar BBQ,325,324,433,438,433,855,557,3365
Golden Eagle,201,481,559,690,659,774,0,3364
Ev Restaurant,320,494,547,573,603,538,288,3363
Tapas Brindisa London Bridge,372,451,460,465,513,628,474,3363
Made in Brasil,288,274,303,311,533,921,732,3362
The Scottish Stores,230,378,515,612,716,624,287,3362
Lucky Voice Karaoke Holborn,169,241,390,606,730,872,354,3362
Dim T,432,546,582,619,570,612,0,3361
Forza Wine,365,467,422,432,593,515,565,3359
The Gladstone Arms,175,520,350,505,652,681,473,3356
Golden Lion,288,373,366,500,603,813,413,3356
LPM Restaurant & Bar,0,642,648,675,592,507,291,3355
St James Tavern,316,361,428,377,602,817,454,3355
The Clarence Dover Street London W1,325,457,566,648,682,676,0,3354
Champagne Charlies,0,533,660,801,667,693,0,3354
Brasserie Blanc - Threadneedle Street,494,663,735,825,637,0,0,3354
Old Town Tavern,132,387,303,429,652,825,625,3353
The Culpeper,234,281,445,682,667,750,293,3352
Salmon & Ball,345,324,389,509,524,702,559,3352
Burger & Lobster Leicester Square,341,359,384,439,584,733,512,3352
The Farriers Arms,532,295,387,391,701,582,463,3351
Lord Aberconway London Ec2,271,474,621,709,695,580,0,3350
The Light Bar & Dining,140,399,536,674,633,739,229,3350
All Bar One Cannon Street,211,418,642,755,670,653,0,3349
The Courtyard WC1,355,303,424,477,558,578,653,3348
The Bishop,211,218,244,284,669,974,748,3348
Obicà Mozzarella Bar,393,542,585,606,495,502,225,3348
"The Euston Flyer, Euston Road",187,303,411,447,541,895,563,3347
The Prince Regent,290,261,345,330,673,908,540,3347
York Islington High St London,230,349,421,545,655,742,404,3346
The Grocer,261,358,441,594,602,647,440,3343
Crown & Anchor,288,331,386,508,567,838,424,3342
Fulham Road Picturehouse,395,423,448,464,575,227,809,3341
Sanxia Renjia Fitzrovia - Chinese Restaurant & Karaoke,326,406,504,406,558,736,400,3336
The Angel,220,400,411,667,663,611,364,3336
"The Sail Loft, Greenwich",267,326,312,373,637,901,518,3334
Gipsy Moth Greenwich,287,294,331,361,622,876,563,3334
Six Portland Road,445,548,324,534,400,538,541,3330
Nest Bishopsgate,243,470,673,825,474,525,120,3330
Opium Cocktail Bar & Dim Sum Parlour,255,307,383,493,637,785,470,3330
Peony Bar @ Opium,255,307,383,493,637,785,470,3330
The Actress,292,287,350,366,619,742,672,3328
Uxbridge Arms Notting Hill,391,439,369,471,542,658,457,3327
MEATliquor Bloomsbury,287,362,573,619,639,603,244,3327
"Long Arm Sports Pub & Brewery, Worship Street",185,431,601,666,473,640,330,3326
The Angel & Crown Pub,0,504,573,419,760,646,423,3325
Greenwood,207,355,517,659,454,674,458,3324
Nonos,344,359,453,340,447,759,622,3324
The Chelsea Corner,0,440,489,484,463,810,637,3323
Allsop Arms,271,362,455,490,664,738,343,3323
Washington Hampstead,377,303,338,335,696,734,540,3323
Morito,268,454,577,592,512,595,324,3322
Howling Hops Brewery and Tank Bar,286,232,346,412,573,925,548,3322
Brackenbury Wine Rooms,301,510,448,661,762,569,70,3321
"Ciao Bella Italiano (Italian food, Italian restaurant, Italian takeaway,)",0,334,456,482,696,620,733,3321
Stables Bar,370,470,134,543,491,760,552,3320
The Rose,308,376,449,624,730,553,279,3319
Pepper Saint Ontiod,210,427,392,600,682,567,440,3318
The Charlotte,182,278,501,642,764,738,210,3315
Hungry Bikes,360,506,512,529,654,439,315,3315
Hackney Coffee Company,181,246,304,621,690,738,535,3315
Lord John Russell,293,375,533,554,679,483,396,3313
The Mayflower Pub,344,367,418,434,565,627,558,3313
The Ship Rotherhithe,274,349,383,391,585,776,554,3312
Black Bear Burger Restaurant Shoreditch,314,336,415,563,553,654,476,3311
Rule Zero,332,181,424,457,422,717,775,3308
Hawksmoor Seven Dials,533,432,428,484,404,516,510,3307
The Woolpack,250,352,452,547,530,680,496,3307
Cock & Bottle,282,413,418,442,618,737,396,3306
Cheeky Chicos Blackfriars,137,575,680,848,682,383,0,3305
The Canonbury Tavern,207,312,341,352,650,843,600,3305
Good Samaritan,394,555,645,547,717,284,163,3305
Story Coffee - Wandsworth,413,437,514,385,548,497,507,3301
Pierre Victoire,361,405,415,458,630,661,371,3301
Dean Swift Pub,257,340,352,611,529,542,670,3301
Hand & Racquet,153,381,431,484,691,677,483,3300
"The Lamb & Flag, Covent Garden",294,402,415,547,516,735,391,3300
Haz,287,489,640,866,473,430,115,3300
Players Social,257,385,412,571,565,737,372,3299
Lady Abercorn's Pub & Kitchen,283,269,445,582,795,682,243,3299
Cock Tavern,226,307,521,404,445,918,477,3298
Made in Italy,364,328,345,376,533,710,642,3298
No 29 Power Station West,312,265,294,387,589,889,561,3297
Smokehouse,212,243,252,457,558,705,867,3294
Halfway House,224,359,331,415,620,823,521,3293
The Colony Grill Room,397,532,506,453,531,695,179,3293
The Footman,262,489,524,652,557,492,316,3292
HW Town Hall,140,0,423,1106,84,505,1034,3292
Crown & Anchor,209,370,403,437,592,759,521,3291
Pickled Hen,422,313,581,528,468,516,462,3290
The Corner Bar,221,359,415,625,788,656,226,3290
Rileys Sports Bar Victoria,265,311,435,482,620,780,396,3289
Richard The First,295,344,288,391,496,753,720,3287
Prince of Wales Feathers W1,264,421,414,622,711,526,326,3284
White Hart Lambeth,191,357,496,444,609,741,446,3284
Le Vieux Comptoir,0,518,626,678,686,727,48,3283
The Yorkshire Grey,214,485,517,748,594,724,0,3282
Phoenix Cavendish Sq London,247,359,494,673,650,547,311,3281
The Euston Tap,279,398,482,532,749,506,332,3278
Sylvan Post,311,314,303,369,684,720,576,3277
The Dockers Inn,149,331,280,453,688,897,479,3277
Trinity Arms,313,339,378,452,618,767,408,3275
Mr Fogg's Tavern,291,445,517,542,47,872,560,3274
The Kensington Wine Rooms,359,493,462,561,468,654,276,3273
The Mason's Arms,211,203,485,457,776,610,530,3272
Caffettino,350,465,530,518,502,362,545,3272
Bella Italia - Wellington Street,316,398,477,491,373,751,466,3272
Tintico,407,575,614,600,513,563,0,3272
"The Crown, Islington",219,284,296,499,543,667,763,3271
Turquoise,403,504,422,653,497,488,304,3271
The Wilton Arms,305,393,556,548,658,429,381,3270
The Turk's Head,283,319,398,414,547,619,689,3269
Katsute 100,409,335,383,356,362,711,712,3268
The Dove,302,330,408,404,464,820,540,3268
Blythe Hill Tavern,341,310,331,503,697,610,476,3268
Theo Randall at the InterContinental,157,639,384,435,565,887,200,3267
Browns Victoria,291,419,433,725,517,619,262,3266
Manicomio Chelsea Restaurant,339,430,499,448,466,639,443,3264
Quick Pick Food & Wine (Westbourne Grove),457,720,311,335,743,429,266,3261
St James Of Bermondsey Bermondsey,297,435,389,543,585,617,394,3260
Rose Pub & Kitchen,202,327,393,432,675,665,566,3260
Green Cactus,440,408,473,528,601,417,392,3259
The Hansom,541,371,459,356,512,388,632,3259
Buvette,504,296,296,564,385,740,473,3258
Harry's Bar & Dining Room,229,603,823,909,684,10,0,3258
The Lock Inn,469,243,361,342,520,843,478,3256
Café Luca,0,502,610,742,668,734,0,3256
Slug & Lettuce Leicester Square,471,416,499,6,750,751,362,3255
The Craft Beer Co. Covent Garden,208,336,400,510,576,880,345,3255
Andy’s Greek Taverna,347,369,440,419,549,565,565,3254
The London Pub,319,402,381,470,588,643,451,3254
Famous Three Kings,181,261,368,313,474,874,782,3253
Ye Olde Swiss Cottage,346,501,451,489,626,578,262,3253
Friend at Hand,271,408,440,511,665,592,366,3253
The George,308,367,432,522,510,682,432,3253
Eight Members Club Bank,260,618,835,1082,445,12,0,3252
"Goose Island Brewpub, London",225,330,458,561,563,751,363,3251
Bubbleology Soho,319,324,414,386,480,766,558,3247
The Blue Anchor,222,290,310,382,706,697,639,3246
Punch & Judy,321,334,391,419,518,809,453,3245
Bangalore Express City,290,425,448,653,628,536,265,3245
The Castle,320,346,344,378,560,722,575,3245
Lady Dinah's Cat Emporium,556,447,0,458,554,637,593,3245
Unity Diner,0,590,602,618,624,810,0,3244
The Fentiman Arms,242,340,389,421,633,656,562,3243
Mitre Greenwich Castle,270,297,336,343,574,798,625,3243
Fire Stables,178,269,254,385,601,893,662,3242
Karaoke Box Soho,253,223,342,403,626,898,496,3241
The Porchester Pub,331,408,383,409,581,567,561,3240
Cahoots London,0,376,449,476,565,880,493,3239
London Cocktail Club - Monument,177,288,453,602,612,747,360,3239
KuPP Paddington,0,416,458,658,530,610,565,3237
The Little Driver,290,186,438,395,510,652,765,3236
The Victoria Inn,238,230,173,342,700,897,652,3232
Anchor Bankside,278,289,350,481,566,832,435,3231
The Clapham North,209,239,280,316,448,1015,722,3229
The Montpelier,240,225,405,422,606,822,509,3229
The Mitre,375,274,305,421,490,620,743,3228
The Scolt Head,232,301,342,434,669,749,501,3228
The Moby Dick,173,368,394,387,575,749,582,3228
Jaks Mayfair,306,282,323,592,619,646,458,3226
Benito’s,459,546,481,657,384,638,60,3225
The Griffin Belle,237,402,450,476,680,560,419,3224
Burger & Lobster Oxford Circus,293,351,364,480,570,752,413,3223
Commercial Hotel Herne Hill,343,321,306,482,535,649,587,3223
Tulse Hill Hotel,194,383,287,336,554,729,739,3222
"The Mason's Arms, Battersea",290,309,415,546,599,565,497,3221
My Village Hawraman Cafe Bar,0,401,238,311,634,909,728,3221
Hawksmoor Air Street,355,361,358,405,427,744,571,3221
Theodore Bullfrog,180,359,487,615,560,795,225,3221
The White Bear,241,365,541,398,561,641,474,3221
Salt Quay Rotherhithe,232,317,320,390,592,816,554,3221
The Royal Oak,343,421,500,519,625,519,293,3220
Sindercombe Social,290,288,348,552,638,662,438,3216
The Carlton Tavern,323,422,279,355,621,628,588,3216
Ottoman,0,445,476,699,614,619,362,3215
Julie's Restaurant,0,635,464,634,758,724,0,3215
Bali Bali,354,441,476,543,598,802,0,3214
The Wigmore,0,521,585,632,756,717,0,3211
The Abbeville,249,220,262,302,632,804,741,3210
The Wilmington,216,298,365,689,609,520,509,3206
temper Covent Garden,285,339,437,524,531,799,291,3206
Le Cochonnet,363,410,275,381,591,572,613,3205
The Gallery Pub,428,388,529,555,544,462,299,3205
Workers Cafe,257,383,477,474,430,634,550,3205
The Greedy Cow,307,394,315,334,612,679,564,3205
El Metro,234,417,494,439,522,529,569,3204
Drayton Arms London Sw5,202,358,392,533,592,702,425,3204
Whiskey Ginger,0,365,447,472,666,812,439,3201
King Charles I,284,307,419,613,725,518,334,3200
The Kings Arms,311,432,495,633,520,519,289,3199
The Islington Town House,254,294,371,453,694,779,354,3199
"Moto - Japanese Sake Bar, Shop & Eatery",0,387,471,368,666,839,468,3199
Rocca,319,682,803,996,398,0,0,3198
"The Ship, Soho",263,369,419,471,633,686,354,3195
Bull Islington,182,169,500,419,568,833,524,3195
The Green Man,313,606,304,284,516,683,487,3193
Be at One Piccadilly Circus,330,318,372,440,649,696,387,3192
Duke of Cornwall,301,331,370,441,637,700,411,3191
The Furzedown,608,280,168,682,523,308,622,3191
The Jolly Sisters,203,375,248,502,520,857,483,3188
The Great North Wood,176,243,410,370,659,774,556,3188
John Snow,303,356,521,589,561,769,88,3187
The Somers Town Coffee House,363,589,544,547,567,358,219,3187
Brewers Inn Pub,242,240,260,500,563,740,641,3186
High Spirit Cocktail Bar,294,577,432,681,573,629,0,3186
The Cockpit,281,335,471,617,559,592,331,3186
Le Mercury,345,308,364,391,548,771,459,3186
The Cow,294,311,382,441,624,557,575,3184
The Punchbowl,254,466,560,709,622,573,0,3184
The Northcote,179,284,312,487,617,876,427,3182
Crown & Two Chairmen London,207,388,397,555,650,654,330,3181
The Golden Heart,236,281,344,483,635,741,460,3180
Dirty Bones Kensington,195,210,277,370,509,1066,551,3178
"The Windmill, Lambeth",229,371,467,576,548,598,389,3178
Leman Street Tavern,238,439,533,667,538,522,240,3177
Tacco,0,692,580,551,564,337,451,3175
"The Red Lion, Mayfair",339,458,522,725,633,498,0,3175
Princess of Prussia,300,487,494,658,681,555,0,3175
Oneills Wardour Street Londo,279,290,334,417,530,807,517,3174
Sagardi,272,367,426,552,604,624,329,3174
Silver Cross,242,304,428,578,521,721,378,3172
Vermuteria,248,306,358,403,481,750,626,3172
Lokanta Bar and Grill,353,407,336,406,666,628,376,3172
Kings Arms Chelsea,216,309,417,584,397,695,552,3170
Vaulty Towers,277,309,389,564,611,624,395,3169
The Roebuck,237,376,332,562,592,597,473,3169
Nightjar,383,365,378,425,485,623,509,3168
Bartons,467,468,379,392,424,531,507,3168
The Imperial Arms,89,336,636,476,376,609,644,3166
Clarette,0,471,466,704,706,819,0,3166
Two Spoons,177,345,443,540,505,748,406,3164
The Sun Tavern,288,315,438,515,513,782,312,3163
Bounce Farringdon,168,272,361,616,718,821,207,3163
Print Room Café - Students' Union UCL,602,683,600,742,534,0,0,3161
The Peckham Pelican,0,418,613,601,628,718,183,3161
All Bar One Victoria,205,351,504,681,591,593,235,3160
Prince of Wales,254,352,540,434,502,546,531,3159
Café Amisha,0,501,493,491,562,667,445,3159
Rossopomodoro Chelsea,0,388,496,510,553,668,541,3156
The Lighthouse Battersea,346,316,256,282,496,868,592,3156
The Rise,265,326,457,391,650,635,429,3153
The Havelock Tavern,332,408,424,438,452,430,669,3153
The Three Crowns,139,240,318,640,790,712,314,3153
KIBOU Japanese Kitchen & Bar,0,389,391,608,609,658,497,3152
Bbar,0,412,531,736,670,803,0,3152
The Thirsty Bear,144,265,429,671,558,806,279,3152
Noura Brasseries,376,455,400,551,498,607,263,3150
"The Shakespeare, Bethnal Green",243,312,418,340,598,823,414,3148
Castle Holland Park,232,292,374,428,675,581,565,3147
Omnibus Theatre,424,381,548,425,443,451,475,3147
Italian Bistro,394,348,436,403,514,593,459,3147
The Enterprise,340,287,373,494,446,709,497,3146
La Bodega de issy,324,262,272,392,474,857,564,3145
Two Brewers,267,349,403,472,507,789,357,3144
The Fox & Hounds,181,146,389,382,465,829,750,3142
Village Soho,211,297,353,426,548,781,524,3140
L'amour,438,352,319,395,653,463,519,3139
Masons Arms,205,432,460,717,716,608,0,3138
Yashin Sushi,331,397,543,608,473,424,361,3137
The Victoria,317,459,417,480,822,606,35,3136
The Crown & Cushion,263,406,347,471,639,579,430,3135
Fox & Firkin,225,193,282,291,512,911,720,3134
Leather Bottle,249,316,263,319,585,911,490,3133
Vinoteca City,364,558,596,730,488,397,0,3133
The Grafton,237,204,306,469,627,710,579,3132
Ninth Ward,0,421,607,619,662,685,138,3132
The Sydney Arms,215,261,412,462,642,793,345,3130
Ye Old White Horse,266,307,581,630,699,629,17,3129
The Fulham Mitre,249,296,425,369,513,681,595,3128
Bella Italia - The Strand,300,284,563,415,415,715,435,3127
De Beauvoir Arms,285,331,292,390,626,657,545,3126
The Windsor,402,421,293,378,658,764,209,3125
The Three Stags,279,150,375,552,592,609,567,3124
Benito's,351,352,418,457,457,712,376,3123
Knowles of Norwood,250,217,453,423,627,664,489,3123
Heritage Restaurant and Cocktail Bar,0,228,330,360,568,975,662,3123
Be At One Regent Street,206,240,335,404,570,840,526,3121
Le Pont de la Tour,275,332,436,533,723,523,298,3120
The Avalon,217,216,278,355,652,864,537,3119
Willows on The Roof - Cocktail Bar & Events Venue - John Lewis Rooftop,307,317,372,483,486,727,425,3117
The Lemon Tree,270,286,447,570,473,686,385,3117
Polpo Chelsea,262,440,455,528,429,670,332,3116
The Alma Pub,256,280,348,453,596,727,455,3115
Gloucester,252,226,373,359,746,700,459,3115
East Putney Tavern,267,289,351,465,693,678,371,3114
The Surprise,150,165,477,445,672,835,367,3111
The Duke,246,275,316,367,650,634,622,3110
Donasao Kitchen & Bar,331,360,406,475,663,546,329,3110
The North London Tavern,269,222,420,490,567,532,609,3109
Piano Lounge & Bar,451,396,362,422,398,543,537,3109
Be At One Greek Street,151,273,326,401,570,796,591,3108
Hen & Chickens N1,308,320,344,302,558,801,474,3107
Sparrowhawk,131,179,362,403,685,802,545,3107
SUSHINOEN,420,337,338,399,581,580,452,3107
The Gregorian,331,301,350,399,694,693,338,3106
The Blues Kitchen,247,247,338,374,579,832,489,3106
Burger & Lobster Threadneedle Street,249,356,426,659,550,603,261,3104
The Lordship Pub,109,257,299,327,624,885,603,3104
Barkney Wick,644,269,523,627,437,379,225,3104
Duke of Hammersmith,206,411,382,468,773,616,247,3103
Tanner & Co,252,328,383,644,527,687,282,3103
The Angel Oak,244,219,267,335,580,861,597,3103
The Artful Dodger,357,321,487,437,518,536,446,3102
Swan,236,361,450,588,785,514,167,3101
Maggie Jones's Restaurant,344,324,350,408,419,643,612,3100
Haverstock Tavern,240,285,300,328,652,746,548,3099
Kings Stores,235,309,472,669,570,508,336,3099
Discount Suit Company,279,348,344,468,562,789,309,3099
Battersea Brewery,226,320,323,446,548,831,403,3097
The Grosvenor pub,339,447,431,343,491,678,367,3096
Duke Of York,230,332,502,535,541,730,225,3095
The Stonhouse,154,237,269,341,710,705,678,3094
CRATE Brewery & Pizzeria,215,206,348,392,583,967,383,3094
The Barbary Next Door,0,413,353,496,557,739,536,3094
The Star of Kings,0,426,447,568,653,751,248,3093
Sapores Lounge,366,267,305,365,475,690,624,3092
Golden Lion,268,406,525,589,523,625,155,3091
Caffè Concerto - Oxford Street,381,354,292,373,422,608,660,3090
Brunswick House Restaurant,0,386,511,634,785,774,0,3090
Dirty Martini Bishopsgate,144,201,339,492,753,743,418,3090
Vila Ronel,319,243,308,386,463,656,714,3089
Ku Bar,281,248,335,411,495,783,536,3089
The Tankard,264,188,371,407,653,793,413,3089
Manor of Walworth,332,268,354,489,498,647,501,3089
Duke of Wellington,215,299,422,498,604,574,477,3089
KHP Social / Coffee Shop,480,448,392,556,460,372,380,3088
The Cobden,178,265,367,473,617,677,510,3087
Cambridge Hotel London Wc2,218,261,378,466,553,865,346,3087
Alwyne Castle Canonbury,264,320,336,414,586,769,398,3087
"The Latymers, Hammersmith",427,473,511,660,467,312,235,3085
"The Sun & 13 Cantons, Soho",177,370,481,622,563,659,213,3085
Kibele Restaurant,304,285,338,442,566,692,456,3083
St Moritz Restaurant,341,344,349,483,500,693,372,3082
Eastway Brasserie,219,330,406,784,455,469,419,3082
PEARL Hackney Wick,291,237,372,465,473,686,558,3082
Mele e Pere,203,284,417,563,548,823,243,3081
The Richmond,342,278,366,310,663,706,415,3080
Touro Brazilian Steakhouse Wimbledon,304,269,316,406,489,605,691,3080
The Flag,517,227,399,329,582,650,374,3078
The Olde Apple Tree,296,201,505,387,651,719,319,3078
The Lamb,261,335,401,559,724,557,239,3076
Little Bat,224,263,317,408,568,804,492,3076
Cacciari's Restaurant,290,384,335,489,584,504,489,3075
Prima Sapori d'Italia,231,337,440,433,387,718,529,3075
The Duke of Sussex,245,371,452,580,543,547,336,3074
Morty & Bob's,248,315,391,462,406,738,513,3073
The Tommy Tucker,172,376,572,425,479,529,519,3072
Lucky Voice Karaoke Soho,232,302,333,505,570,784,346,3072
London Cocktail Club - Liverpool Street,197,324,391,555,618,578,409,3072
Bibimbap Soho,280,385,362,432,398,736,478,3071
Canton Arms,180,292,389,477,546,615,571,3070
Black Sheep Coffee & Cocktails,326,751,707,813,472,0,0,3069
"The Hercules, Lambeth",78,352,399,484,702,665,388,3068
The White Hart,224,243,286,439,739,756,381,3068
Marquess of Anglesey,258,338,383,498,506,755,328,3066
Berkshire Lounge Bar,401,330,402,401,388,673,470,3065
280 Degrees African/ Nigerian Restaurant/Bar&Girll) Kilburn,332,380,217,347,584,667,537,3064
The Albion,269,504,563,556,534,403,234,3063
Sun,248,277,336,517,526,750,409,3063
The Duke of Wellington,338,298,313,305,519,845,444,3062
Market Place Bar,220,381,451,581,653,699,77,3062
Ember Yard,243,323,377,517,528,743,331,3062
The Two Bridges Ale House & Kitchen,155,275,396,647,544,750,295,3062
Clock House,266,219,242,288,492,903,652,3062
Crofton Park Tavern,329,243,304,458,545,564,619,3062
The Quality Chop House,0,435,559,610,562,510,385,3061
Capeesh,238,409,364,416,655,550,429,3061
Tina We Salute You E20,296,321,483,366,587,649,358,3060
The Distillery,161,218,318,342,604,1023,393,3059
Sun In Splendour Notting Hill,198,256,323,416,545,812,508,3058
Watsons General Telegraph,316,356,303,226,663,814,380,3058
Marquis Cornwallis,277,391,446,675,496,478,294,3057
El Camion,230,361,445,532,543,672,272,3055
The Keep of Brook Green,236,265,343,465,607,652,486,3054
Mamuśka! Polish Kitchen and Bar,251,283,349,421,490,799,460,3053
Zefi,276,343,325,509,548,612,439,3052
Yen Burger,431,310,452,413,486,528,432,3052
The Spice Of Life,282,261,367,455,579,760,347,3051
The Horns Tavern,377,294,429,233,592,584,541,3050
The Hercules Pillars,274,410,460,535,478,764,128,3049
The Drift,233,361,488,824,558,584,0,3048
All Bar One Wimbledon,257,264,363,386,731,741,305,3047
Quinns Camden,0,279,287,446,671,826,536,3045
The Victoria,204,257,375,437,599,691,482,3045
Slatterys,622,222,307,370,591,685,247,3044
The Hanbury,261,366,296,458,496,682,485,3044
The Railway Tavern,223,340,433,666,608,535,238,3043
Bella Italia - Cranbourn Street,356,352,316,469,493,610,447,3043
L'antico Restaurant Pizzeria Bar,429,443,585,337,442,392,414,3042
The Elgin - Maida Vale,179,277,445,418,548,847,328,3042
All Bar One Liverpool Street,156,254,422,655,700,734,121,3042
805 Restaurants,307,286,321,326,563,595,644,3042
Wolfpack Fulham,147,343,412,416,516,781,424,3039
Lincoln Lounge,317,446,606,490,671,509,0,3039
The Little Taperia,273,326,238,430,569,724,478,3038
The Hawley Arms,162,232,237,377,597,927,506,3038
Brewhouse & Kitchen - Hoxton,204,446,391,517,640,518,322,3038
Simmons Bar | Oxford Street,146,176,236,431,622,883,543,3037
Queens Arms London,281,353,249,354,665,685,448,3035
Golden Lion Fulham,285,257,397,332,652,762,349,3034
The Hermits Cave,345,294,386,438,592,631,348,3034
The Captain Kidd,201,233,326,435,608,787,444,3034
Mare Street Market,262,223,247,367,616,885,434,3034
Pub On The Park,195,250,298,303,541,928,519,3034
The Perception at W London,333,237,375,305,382,875,525,3032
The Grove Balham,187,208,227,436,635,764,574,3031
Windsor Fenchurch,226,452,599,761,835,158,0,3031
The Crown Tavern,195,391,594,681,469,483,217,3030
TwoRuba,220,338,389,627,641,658,157,3030
Carmen Tapas,404,289,365,362,473,523,613,3029
The Stewart Arms,356,308,344,442,769,361,447,3027
The Queens,241,309,356,339,482,774,526,3027
The Great Southern Pub,0,111,354,532,546,760,724,3027
Prospect of Whitby,271,247,297,455,519,773,465,3027
The Jolly Gardeners,252,328,333,379,573,656,504,3025
Mem & Laz Brasserie,240,300,279,424,600,746,436,3025
The Blind Beggar,147,287,313,460,670,930,218,3025
Retro Cafe 2.0,573,392,430,472,600,311,246,3024
The Rose & Crown,240,223,306,270,565,755,665,3024
The Pyrotechnist's Arms,168,215,273,441,642,802,483,3024
The Sporting Page,276,304,522,422,605,492,402,3023
Dirty Bones Shoreditch,121,196,253,439,654,894,466,3023
Davy's Wine Vaults - Greenwich,295,307,402,401,496,717,404,3022
Duke of Battersea,223,242,306,398,643,901,307,3020
The Bricklayers Arms,238,314,486,566,628,569,219,3020
The Chandos,253,320,333,503,523,733,353,3018
The Prince Bonaparte,250,253,350,328,643,582,611,3017
Terra Terra,0,381,468,526,651,669,322,3017
The Secret Bar,125,149,410,416,668,794,455,3017
The Diner - Spitalfields,261,237,309,383,501,741,585,3017
Common Counter at Glass House,0,365,501,605,480,542,524,3017
Day & Night Islington,0,393,406,440,738,788,251,3016
Yashin Ocean House,242,352,449,477,634,397,463,3014
The Lord Tredegar,196,463,314,424,534,480,600,3011
Green Man,261,301,433,571,526,508,410,3010
Urban Golf,307,302,470,634,659,638,0,3010
The Salusbury Pub,235,262,403,394,648,641,426,3009
Vagabond,269,369,493,595,488,620,175,3009
The Old Oak,291,280,367,319,581,580,590,3008
Phoenix Arts Club,260,199,317,446,607,613,566,3008
The Mayor of Scaredy Cat Town,262,269,245,368,457,914,493,3008
Market Place Restaurant,272,262,347,475,491,772,387,3006
Chelsea Funhouse,12,163,284,430,679,954,480,3002
Coq d'Argent,294,513,589,590,615,400,0,3001
Pride of Pimlico,326,420,379,424,697,408,346,3000
"Railway Tavern, Norwood",218,206,262,277,559,883,595,3000
Violet's,117,258,259,534,556,854,422,3000
Black Sheep Coffee & Cocktails,476,552,518,637,420,204,191,2998
Montys Bar,178,151,224,241,541,941,721,2997
Rules,0,0,655,705,641,575,420,2996
The Old Nuns Head,229,259,287,355,612,691,563,2996
Upstairs At Rules,0,0,655,705,641,575,420,2996
Marquis Of Westminster,345,402,372,569,479,454,372,2993
Bala Baya,259,328,402,533,495,618,358,2993
Bottega Prelibato,242,450,578,604,551,568,0,2993
Mr. White’s English Chophouse London Whitechapel,220,432,435,476,637,443,350,2993
The Herne Tavern,0,368,358,423,649,661,531,2990
The Lauriston,265,283,437,307,518,717,462,2989
Shoreditch Wine House,239,394,486,659,474,538,199,2989
Star & Garter,128,241,407,523,600,838,252,2989
Garrick Arms,191,253,328,449,494,859,414,2988
South Place Chop House,189,480,583,669,352,555,158,2986
The Gun,65,276,335,394,693,648,574,2985
The Breakfast Club,388,318,324,351,430,566,607,2984
White Horse,181,330,288,382,636,755,412,2984
Be At One - Covent Garden Lyceum,139,407,414,452,572,851,147,2982
The Globe in Morning Lane London,527,174,295,306,538,493,649,2982
B@1 Cocktail Bar,139,407,414,452,572,851,147,2982
The Chancellors,281,216,405,369,614,678,415,2978
Foley's,382,272,354,540,523,574,333,2978
The Angel,229,249,253,320,564,829,533,2977
Prince of Wales,182,272,362,384,623,762,391,2976
The Paternoster,255,376,514,712,551,309,259,2976
Rotunda Bar and Restaurant,174,166,397,646,545,680,364,2972
Iris Avenue,290,451,380,539,661,650,0,2971
Stein's Berlin,123,329,463,574,567,615,299,2970
Quaglino's,200,226,398,457,634,704,351,2970
Be At One - Farringdon,148,237,281,648,763,761,132,2970
The Brigade Bar + Kitchen,340,545,731,762,592,0,0,2970
The Carpenters Arms,248,387,419,649,512,437,317,2969
Constitution,0,470,436,490,559,449,565,2969
The Albion,219,259,283,388,463,663,690,2965
Piazza Italiana,0,542,689,710,661,363,0,2965
M Bar,271,879,751,811,249,0,0,2961
The Nags Head,215,244,439,472,541,684,365,2960
Lucy 1st Ethiopian Restaurant & Bar London,329,257,283,264,338,657,832,2960
21 Covent Garden,166,315,259,280,630,826,484,2960
Garden Bar,206,322,444,402,670,564,351,2959
Brewdog Camden,221,361,393,344,542,819,278,2958
Fox on the Green,211,297,297,365,506,857,425,2958
The Curtains Up,260,268,370,415,586,557,501,2957
"The Castle, Tooting",198,216,382,389,646,739,387,2957
The George,0,271,502,827,489,868,0,2957
BrewDog Shepherd's Bush,259,298,418,450,530,738,263,2956
Earl Of Camden,244,287,307,372,525,805,415,2955
Falcon Clapham North SW4,183,213,226,376,664,858,435,2955
The Botanist Broadgate Circle,192,340,514,699,577,606,27,2955
Library Islington,252,361,334,344,650,663,350,2954
Spinach Restaurant,325,228,336,429,422,703,509,2952
Walker Briggs,203,205,317,405,627,720,473,2950
Mikkeller Bar London,197,251,325,410,641,747,379,2950
Art & Craft SW16 Beer Bottle Shop,304,425,489,533,610,409,179,2949
Homeboy Bar Embassy Gardens,123,265,325,477,667,701,390,2948
Il Cucciolo Restaurant,389,399,424,485,545,705,0,2947
City of Quebec,306,322,350,439,577,545,407,2946
The Joiners Arms,222,241,520,350,505,659,449,2946
Arthur Hooper's,282,526,707,677,358,396,0,2946
The Union Paddington,227,377,459,536,524,512,310,2945
Two More Years,131,216,381,594,488,834,301,2945
Cafe La Divina,272,260,351,429,557,572,503,2944
The Dog House,159,215,383,459,629,701,397,2943
Acacus Libyan Restaurant & shisha,0,186,562,417,550,566,659,2940
The Breakfast Club on Berwick Street,484,339,360,196,583,454,524,2940
Al Forno Wimbledon,238,280,337,331,504,695,554,2939
Kings Head,266,259,249,329,569,831,436,2939
Freedom Bar,159,261,377,430,506,793,413,2939
Bear & Staff Charing Cross Roa,250,244,310,333,544,841,417,2939
Trellick Lounge,409,358,354,381,373,520,543,2938
Be At One - Russell Street,141,276,368,429,504,777,443,2938
The Dublin Castle,178,252,263,290,507,785,662,2937
The Old Red Lion,221,241,334,332,571,657,581,2937
dim t,366,354,415,485,479,436,400,2935
"Princess Louise, Holborn",260,395,461,619,517,683,0,2935
The Old Frizzle,163,244,290,356,629,743,509,2934
The Bolton Kensington,246,360,477,372,506,650,323,2934
"The Ship, Southwark",83,476,368,611,481,723,192,2934
Walpole Pub & Kitchen,129,315,292,491,686,541,480,2934
Cafe Kick,227,359,325,513,517,500,492,2933
Harmony Place Cafe & Bar,0,431,422,441,652,592,395,2933
Lord Morpeth,239,374,379,349,562,555,474,2932
Comptons,343,290,319,370,531,630,446,2929
The Coffee Room Surrey Quays,447,397,466,394,340,436,449,2929
Epoc,400,164,405,543,323,681,413,2929
Vineyard,166,234,278,338,611,957,344,2928
Two Hundred Rye Lane,319,308,327,405,565,633,371,2928
Coravin Wine & Bubbles Bar,0,355,499,654,666,752,0,2926
Old Eagle Pub,252,400,402,386,635,510,341,2926
Bella Italia - Irving Street,285,265,320,340,433,819,462,2924
Flowers of the Forest,135,251,313,627,733,519,346,2924
Flare Carnaby,240,264,297,357,492,796,477,2923
Wright's Bar,452,461,536,606,611,256,0,2922
The Trafalgar Arms,226,314,336,335,642,644,423,2920
Whippet Inn,230,250,313,401,635,487,603,2919
The Kings Head,244,471,562,471,559,612,0,2919
The Latchmere,320,249,281,231,438,794,602,2915
Sushi and Robata by Genji,280,535,513,691,440,88,367,2914
Quo Vadis,0,485,582,644,654,549,0,2914
Over Under Ladbroke Grove,369,396,526,334,400,389,498,2912
The Open Page,91,332,287,436,649,719,398,2912
The Captain Cook,201,229,255,354,600,797,475,2911
The Grapes SW18,293,371,417,558,815,449,7,2910
Dog & Duck Bateman St London W,215,260,319,425,555,804,328,2906
The Duck and Rice,0,344,406,441,499,736,480,2906
Pachamama East,313,305,438,422,504,541,379,2902
Bridge House W2,166,166,259,341,533,797,639,2901
ISLA RAY,320,0,280,346,565,821,569,2901
The Lock Tavern,86,187,291,477,536,860,463,2900
"Nags Head, Covent Garden",310,287,295,346,386,728,548,2900
Ye Olde Cheshire Cheese,245,371,473,529,555,725,0,2898
Fleets,245,413,461,709,566,504,0,2898
"Spread Eagle, Camden",234,312,344,366,575,704,362,2897
The Sun Pub,186,333,363,661,565,789,0,2897
Bar 61 Restaurant,360,410,329,337,484,543,433,2896
Norfolk Arms,219,326,476,482,601,454,338,2896
Atrio Restaurant & Bar,324,315,257,378,425,677,520,2896
Iberica Marylebone,293,384,414,498,610,696,0,2895
The Chandos,266,230,289,359,674,611,466,2895
The 10 Cases,306,307,370,530,666,715,0,2894
Kua 'Aina (Carnaby Street),271,310,314,456,497,745,300,2893
The Kennington,187,264,277,483,604,498,579,2892
The Peasant,0,0,496,599,498,769,530,2892
Bell Bush Lane Ec4,328,529,697,678,659,0,0,2891
Bradley's Spanish Bar,280,287,349,540,697,593,144,2890
10 Greek Street,0,239,559,704,653,735,0,2890
Hannah,110,192,240,276,595,981,495,2889
Bar Crispin,313,458,432,478,581,522,104,2888
The Porterhouse,0,279,406,533,601,831,237,2887
The Drapers Arms,222,269,330,385,502,483,696,2887
Simmons Bar | Old Street,208,228,224,417,561,791,458,2887
The Antelope,275,224,275,315,600,735,461,2885
Castle Portobello London,291,166,270,258,516,845,538,2884
The Earlsfield Gastropub,163,165,266,232,625,916,517,2884
The Candlemaker,142,204,261,353,361,945,618,2884
Caxton Grill,223,404,563,672,453,239,330,2884
The Horn of Plenty,13,424,343,439,550,691,422,2882
The Dundee Arms,139,219,331,373,647,777,394,2880
The Castle,222,421,516,659,554,507,0,2879
28-50 Wine Workshop & Kitchen,172,309,351,425,510,698,413,2878
Bermondsey Bar and Kitchen,224,324,444,612,615,581,78,2878
Netil Radio & Bar,190,272,315,421,518,769,392,2877
The Harcourt,211,354,518,344,496,735,218,2876
The Kings Arms,0,369,409,472,497,604,525,2876
Majesty Lounge,219,311,407,417,513,484,524,2875
The Ship,188,223,239,288,543,810,583,2874
nue ground,287,275,340,409,404,511,648,2874
The Belle Vue,190,260,313,402,504,726,478,2873
Hackney Bridge,0,387,422,433,464,718,449,2873
Condesa,249,258,236,616,630,884,0,2873
Gaucho Chancery Lane,257,397,454,506,617,641,0,2872
The Pavilion,386,263,341,309,690,633,249,2871
Eli’s Restaurant - South Kensington,326,403,358,546,427,810,0,2870
"The Trinity, Borough",298,247,300,407,334,786,498,2870
Satan's Whiskers,280,378,409,427,518,464,393,2869
Casa Malevo,311,279,421,570,498,442,347,2868
Vinoteca Marylebone,288,397,389,603,497,694,0,2868
Dragon Inn Club,469,413,346,324,485,516,315,2868
Island Queen Islington,168,291,352,482,549,653,372,2867
The Refinery New Street Square,362,644,540,820,498,0,0,2864
The Port House,128,357,539,546,567,727,0,2864
"The Prince Edward, Bayswater",160,159,234,475,669,723,443,2863
Kings Head London,270,331,424,684,546,608,0,2863
Bar Story,356,261,372,337,523,715,299,2863
Golden Lion,216,234,260,315,549,578,710,2862
Grove House Tavern,219,339,297,334,640,646,386,2861
The Victoria Dalston,210,284,310,411,486,733,426,2860
Crown,251,294,363,423,450,713,365,2859
Trullo,335,411,420,486,504,418,285,2859
"The Astronomer, EC1",184,316,439,635,544,560,177,2855
London Hospital Tavern,270,352,399,459,648,663,64,2855
Smiths of Smithfield,200,414,580,874,587,179,19,2853
Narrowboat,142,227,336,394,417,767,569,2852
Brewmaster,222,239,307,381,516,776,411,2852
Meraki Restaurant & Bar,0,524,582,602,589,554,0,2851
Marquis Of Granby,323,583,617,653,647,28,0,2851
The Ship & Shovell,146,292,515,600,585,713,0,2851
Well & Bucket,0,241,304,453,569,857,427,2851
Bar Elba,173,254,379,421,607,711,305,2850
Ye Ye Noodle and dumplings,317,397,385,415,358,499,479,2850
Soho Joe,0,356,433,438,754,869,0,2850
The Tankard,0,0,425,420,634,877,493,2849
Jazz After Dark Ltd,0,240,458,598,542,787,223,2848
The Finery,165,321,510,580,718,553,0,2847
The King & Co,388,278,350,360,565,625,281,2847
White Swan,193,658,440,714,600,242,0,2847
The Harrison Pub & Hotel,189,270,374,489,462,515,547,2846
Social,148,301,262,385,623,795,332,2846
Tarmon Free House London,419,245,350,452,499,544,332,2841
The Hop Exchange,700,472,527,675,409,58,0,2841
Hemingways,104,143,313,472,719,335,754,2840
Queensway Market,409,379,422,416,517,402,295,2840
Two Point Thai,0,488,383,571,547,439,412,2840
Feeleys,157,132,321,418,465,770,577,2840
The Broadcaster White City,0,439,590,740,548,377,145,2839
Crown & Anchor London Nw1,204,332,453,512,671,380,287,2839
Floripa,228,237,293,402,467,698,514,2839
Bethnal Green Tavern,174,279,361,392,611,711,311,2839
Grumbles,264,393,528,399,432,462,360,2838
The Sekforde,189,337,551,576,510,383,292,2838
Le Joint Fish and Wine Bar,247,178,257,335,578,740,503,2838
Jolly Gardeners Putney,192,437,368,416,408,594,420,2835
Victoria And Albert,184,175,287,427,770,722,269,2834
Yama Momo,256,256,289,302,629,676,425,2833
The Italians wine bar deli,352,150,304,379,595,516,535,2831
BENARES RESTAURANT | MAYFAIR,0,515,394,661,638,623,0,2831
"The Queen's Head, Hammersmith",205,404,411,587,443,358,422,2830
The Fiddler's Elbow - Music Venue,211,250,276,316,444,809,523,2829
Sports Bar & Grill Canary Wharf,161,236,355,504,371,711,489,2827
Kybelle - Cafe & Bar,271,313,333,419,281,644,566,2827
The Bedford Arms,253,318,364,283,523,793,291,2825
Aline Lebanese Kitchen,429,390,399,531,422,654,0,2825
Haz,225,496,538,744,456,260,105,2824
Barefoot Joe's Bar,206,180,249,262,607,670,650,2824
The Warwick Arms,233,435,477,403,521,328,426,2823
Anacapri,196,479,483,582,555,528,0,2823
London Grace,0,0,679,427,692,606,419,2823
The Black Horse,83,184,234,419,580,774,549,2823
The Cock Tavern,331,99,381,332,639,548,492,2822
Marksman Public House,0,0,363,395,552,775,737,2822
Black Sheep Coffee & Cocktails,373,645,659,799,345,0,0,2821
Duke of York,152,260,333,474,637,554,411,2821
London Cocktail Club,104,185,319,526,566,903,217,2820
Prince of Wales,337,252,265,348,603,596,418,2819
The Burlington Arms,223,383,494,734,532,453,0,2819
The Grange Pub,240,244,281,496,670,580,306,2817
Royal Albert,318,217,262,282,505,547,686,2817
The Star of the East,211,404,268,425,564,533,412,2817
The Fox Club,464,448,764,620,520,0,0,2816
Marquis Of Granby Rathbone St,219,362,461,660,534,394,186,2816
Halfway To Heaven,223,240,275,313,486,861,418,2816
The Ferry House Pub,213,268,374,328,600,654,379,2816
Ishtar,239,271,428,441,490,618,327,2814
Momento Lounge Bar/The Edge,126,219,307,592,689,739,141,2813
The Pig & Whistle,188,327,393,403,464,657,380,2812
The Grumpy Pub Company,188,327,393,403,464,657,380,2812
Enoteca da Luca - St Paul's,372,615,571,777,477,0,0,2812
Cottons Shoreditch,244,245,256,374,518,792,383,2812
Albertini Restaurant,341,374,578,540,421,557,0,2811
Red Dog Saloon - Hoxton Restaurant,226,207,282,430,603,786,277,2811
The Great Exhibition,182,259,214,263,528,830,535,2811
The Kings Arms,161,252,536,578,577,547,159,2810
Funky Cellar,0,241,453,396,760,726,233,2809
Olives and Meze,287,281,407,442,545,542,304,2808
Rossopomodoro Camden,0,433,417,442,527,605,382,2806
Crown Brewer St Soho W1,194,248,406,514,508,722,214,2806
Trieu Nails London,0,554,412,506,665,434,234,2805
Salsa! Soho,341,283,297,263,401,663,554,2802
Belushi's London Bridge,186,228,282,391,494,655,565,2801
The Clarence,145,175,333,267,650,742,488,2800
Beso Restaurant - Covent Garden,290,272,341,304,387,745,460,2799
Clerkenwell & Social,263,404,462,661,540,469,0,2799
The Camberwell Arms,0,300,410,476,537,737,339,2799
The Clifton,333,291,311,333,413,413,704,2798
The Coborn,208,182,363,402,448,490,705,2798
Savoy Tap,0,480,594,606,497,619,0,2796
The Sipping Room,186,297,393,503,625,513,279,2796
Little Creatures Brewing,0,0,434,750,787,560,264,2795
The Regent,207,91,241,538,567,751,400,2795
Fitzroy Tavern,189,305,402,551,582,544,221,2794
The Tavern,268,342,350,375,471,673,314,2793
Dirty Martini Covent Garden,198,220,260,298,423,851,543,2793
Rossopomodoro Covent Garden,0,362,369,428,475,659,497,2790
All Bar One Houndsditch,246,288,451,692,506,607,0,2790
Kasa and Kin,261,313,392,546,458,508,311,2789
Duke Of Wellington,236,272,348,337,584,689,322,2788
som saa thai restaurant,312,289,349,403,484,479,470,2786
Northcote Arms,0,237,265,318,701,875,389,2785
"The Viaduct Tavern, EC1",227,329,555,689,644,341,0,2785
Rocket,292,593,643,702,554,0,0,2784
Cittie of Yorke,279,333,410,556,564,640,0,2782
The Clove Club,311,509,488,442,508,523,0,2781
Rising Sun,0,322,425,624,535,522,351,2779
The Eagle,248,325,351,426,465,449,515,2779
Green Man Soho W1,316,331,317,382,485,632,314,2777
Nolan's,349,347,203,473,461,557,387,2777
Double Standard,284,320,283,478,549,562,301,2777
The Kings Arms,199,186,338,400,633,685,336,2777
Phoenix,185,258,289,371,574,696,402,2775
Simmons Bar | Kings Cross,149,238,275,408,635,700,370,2775
"Brinkley's Wines Fulham, formerly Joe's Brasserie",243,359,618,536,538,480,0,2774
The Camel & Artichoke,168,224,371,510,586,752,163,2774
Off Broadway,213,264,318,349,504,685,439,2772
Harrods Pizzeria & Pasqua,329,379,328,462,381,548,341,2768
Two Floors,194,313,347,476,580,612,246,2768
127 Bar and Restaurant,323,278,408,406,667,677,9,2768
Baraka Restaurant London,250,330,564,643,474,370,137,2768
Bridewell Centre,287,375,366,298,366,775,301,2768
GA KingsX - Bar & Kitchen,0,409,403,504,653,466,331,2766
The North Star,261,306,474,404,545,467,306,2763
Fitzroy Wine Cellar & Kitchen,248,456,451,545,577,486,0,2763
Vinoteca Farringdon,368,360,465,612,478,479,0,2762
Cahoots Ticket Hall & Control Room,0,174,258,482,608,921,318,2761
The Skinners Arms,307,403,458,463,597,532,0,2760
The Man of Kent,189,268,383,394,637,531,357,2759
The Sands End,0,0,536,446,633,637,506,2758
Cable Cafe,256,552,343,328,442,433,403,2757
The Admiral Codrington,0,0,290,622,695,644,505,2756
THE BARLEY MOW,284,439,448,539,606,440,0,2756
Lyttelton Arms Camden,117,343,441,678,474,572,131,2756
Camino King's Cross,212,338,496,531,609,500,70,2756
Ceviche Soho,221,263,407,351,439,697,377,2755
Margaux,0,295,409,587,738,725,0,2754
The Coach & Horses,178,192,290,389,472,737,495,2753
Curzon Hoxton,267,282,241,356,381,610,616,2753
Tank & Paddle Bishopsgate,121,254,460,611,538,638,130,2752
Santini,389,453,521,457,556,374,0,2750
Lyceum Tavern,16,397,538,485,353,683,278,2750
Knowhere Special Islington,0,182,317,448,654,754,394,2749
City Social,0,512,536,609,540,552,0,2749
Bombay Spice,293,362,349,485,392,481,386,2748
The Kings,187,259,251,300,505,790,456,2748
Mc & Sons,172,343,425,607,574,626,0,2747
The Golden Lion,225,376,349,560,506,344,385,2745
hicce restaurant & mkt,143,257,289,351,454,749,501,2744
Peace and Riot,155,192,213,398,375,825,586,2744
Big Town,112,134,314,341,518,802,522,2743
Andanza,348,349,382,533,453,482,195,2742
Camden Road Arms,112,347,191,348,599,876,268,2741
The Racketeer,168,240,333,429,620,626,324,2740
Camden Head,243,265,334,465,481,633,319,2740
BAFTA,488,536,701,556,458,0,0,2739
Spiritland King's Cross,0,283,348,414,687,778,225,2735
The Nell Gwynne Tavern,259,292,471,521,536,656,0,2735
Hawksmoor Guildhall,254,506,552,547,550,326,0,2735
Prince George,237,215,173,257,602,635,616,2735
Adam and Eve,228,388,469,701,448,449,50,2733
Pix Pintxos,160,229,318,418,527,743,338,2733
El Pirata of Mayfair - Tapas Bar Español,0,476,546,600,461,649,0,2732
Plume Wine Bar by Grays & Feather,0,257,368,428,518,786,375,2732
Duke Of Wellington,207,315,396,586,452,468,307,2731
Maggies Bar,220,297,312,336,683,485,396,2729
Murano,0,453,497,525,620,634,0,2729
The Old Bank of England,213,312,453,636,588,527,0,2729
The Pepper Tree,372,326,262,442,428,501,397,2728
"The Distillers, Hammersmith",156,254,408,519,522,577,291,2727
The George & Vulture,296,273,388,496,496,516,261,2726
The KPH,115,196,271,488,576,709,370,2725
The Virgin Queen,158,192,358,281,500,712,524,2725
The Compton Arms,0,199,436,456,552,728,353,2724
The Old Red Lion,254,393,432,576,610,458,0,2723
The Britannia - SMOK'D,189,322,401,498,604,426,283,2723
Beast,287,302,449,474,617,593,0,2722
Mr Fogg's Gin Parlour,0,0,518,398,677,648,481,2722
The Florist Arms,243,265,370,493,591,565,194,2721
Two Brewers,109,338,356,271,379,875,392,2720
Craft & Courage,241,256,369,314,539,545,456,2720
The King's Arms Wandsworth,176,290,251,343,557,770,330,2717
The Cally,170,316,375,487,670,485,213,2716
Ibérica,12,522,550,576,649,407,0,2716
King's Head Theatre Pub,173,315,275,392,464,698,399,2716
The Angelic,159,241,269,337,401,805,502,2714
Tropix,233,190,291,300,482,753,464,2713
Simon The Tanner,0,455,408,339,572,591,348,2713
The Harrods Tea Room,303,340,326,281,456,600,406,2712
"Railway Tavern, Lower Sydenham",156,223,292,363,432,645,601,2712
Old Brompton Wine & Cheese,0,0,871,503,403,509,424,2710
Old Shades,207,255,410,502,412,659,264,2709
Old Ivy House,190,459,412,580,469,387,212,2709
All Bar One Clapham Junction,201,198,245,376,612,817,258,2707
The Sun of Camberwell,179,269,324,361,603,546,425,2707
Brazen Monkey Karaoke,188,311,332,389,380,717,388,2705
The Old Blue Last,138,238,325,379,497,769,359,2705
86 St James,470,348,478,445,560,403,0,2704
Savoir Faire Restaurant,287,307,309,394,516,658,233,2704
Sartoria,461,383,473,489,441,456,0,2703
Duke of York,229,421,434,642,555,386,35,2702
Yurt Cafe,292,310,348,378,278,532,563,2701
MEATliquor SW11 - Northcote Road,206,304,295,343,463,651,438,2700
Opa-opa,222,264,367,370,598,541,338,2700
London Grace,0,0,406,871,719,579,124,2699
The Horseshoe Inn,119,270,431,587,617,514,161,2699
Beer Merchants Tap,178,197,295,347,480,798,404,2699
Sports Bar & Grill Farringdon,143,300,321,551,345,656,382,2698
The Two Brewers,299,393,526,637,497,336,10,2698
Aperi Deli,366,423,363,300,650,372,222,2696
Kino Bermondsey,299,392,364,344,226,552,519,2696
Grapeshots,0,363,460,630,590,652,0,2695
Bierschenke,99,239,416,585,614,741,0,2694
The Hoop and Grapes in London,184,380,369,580,498,529,154,2694
Mezcalito Chelsea,0,279,262,347,481,900,424,2693
Alebrijes,0,279,262,347,481,900,424,2693
Karaoke Box Mayfair,71,171,291,461,505,878,316,2693
Halo,468,353,240,467,415,382,368,2693
The Marquess Tavern,51,148,250,403,624,822,395,2693
White Horse,216,401,593,724,590,169,0,2693
The Old Queens Head Pub,197,233,277,304,421,741,519,2692
zero 75,223,246,300,378,684,632,227,2690
The Cherry Tree,176,224,262,270,472,760,526,2690
The Beer House,321,0,565,446,514,539,301,2686
Fountain & Ink,193,296,420,660,550,567,0,2686
Bourne & Hollingsworth Buildings,0,0,258,330,422,1058,618,2686
The Three Johns,181,268,437,570,477,535,217,2685
Gibney's London,0,175,289,518,578,881,244,2685
Molly's Cafe,0,445,380,444,413,480,523,2685
The Approach Tavern,167,433,274,293,491,567,460,2685
Duke of Argyll,181,236,256,358,487,744,422,2684
Cho Sim,252,389,354,225,346,609,508,2683
Sophie's Chelsea,241,213,277,306,434,710,502,2683
The Alpaca,137,166,239,351,544,756,490,2683
The Duke of Wellington,167,300,424,525,390,495,381,2682
Apothecary,0,274,382,455,665,794,111,2681
Simmons Bar | Fitzrovia,115,206,430,621,616,621,71,2680
The Bancroft Arms,269,272,492,312,371,491,473,2680
Vagabond,219,322,357,481,408,590,301,2678
Soho Residence,125,208,300,381,519,726,419,2678
Cambio De Tercio,100,368,385,449,563,516,296,2677
The Candlemaker,238,373,479,689,506,310,78,2673
Fare,252,364,487,642,550,377,0,2672
Quinta,0,398,383,480,659,751,0,2671
Merchant House London,170,398,390,494,493,679,47,2671
Edinboro Castle Camden Town,127,183,194,523,532,715,396,2670
Hollywood Arms,175,178,236,471,507,748,354,2669
"The Inn of Court, Holborn",274,420,500,578,515,381,0,2668
Hakata Ramen + Bar,200,202,388,411,421,592,454,2668
The Albert Arms,0,211,286,465,524,621,557,2664
Music Room London,637,735,512,583,197,0,0,2664
SALT Deptford,192,235,368,357,558,630,324,2664
The Hammersmith Ram,138,314,389,517,601,467,236,2662
Jihwaja,201,218,329,386,539,756,233,2662
manteca,409,398,631,482,403,338,0,2661
The London Gin Club,0,0,472,492,632,833,231,2660
Lord Clyde Southwark Bridge,141,260,363,504,542,617,233,2660
Prince of Wales,167,216,376,450,439,737,272,2657
Crutched Friar,165,451,669,775,489,108,0,2657
The Brougham,151,243,530,528,465,431,308,2656
Dalla Terra Wine Bar & Restaurant,181,213,299,362,518,772,310,2655
The Star of Bethnal Green,0,282,278,309,499,760,527,2655
The Toucan,196,248,327,535,620,727,0,2653
Llerena,184,117,341,327,503,734,447,2653
Old Red Cow,135,327,415,685,328,479,283,2652
MBER,0,360,535,675,608,474,0,2652
The Princess of Shoreditch,0,0,496,730,565,407,454,2652
Black Horse,141,398,466,680,514,452,0,2651
Fatt Pundit,0,371,543,512,589,636,0,2651
Berber & Q - Shawarma Bar,0,263,344,395,500,587,559,2648
Hector & Noble,76,153,391,285,321,839,583,2648
Kazan,215,398,508,466,514,546,0,2647
The Oyster Shed,113,326,440,674,530,467,97,2647
Hop Kingdom,447,223,296,306,506,615,254,2647
Hawksmoor Knightsbridge,257,253,292,302,470,683,388,2645
Desperados Angel Restaurant,130,308,326,361,505,607,408,2645
The Bobbin,0,187,327,229,484,644,772,2643
Chutney Mary,329,414,428,494,436,542,0,2643
The Boot,175,191,323,449,636,495,373,2642
The Hole In The Wall,189,318,321,382,479,740,213,2642
The Anthologist,220,431,553,804,570,0,64,2642
Signature Brew Haggerston,251,185,336,366,494,722,288,2642
LoveBrunch.co.uk,259,522,567,509,524,156,105,2642
Kings Arms,166,293,483,625,545,383,146,2641
Savage Garden LDN,0,0,450,585,676,613,317,2641
The Sussex Arms,266,230,264,302,503,616,458,2639
Barshu Restaurant,141,343,443,368,440,567,337,2639
Brood,0,395,481,475,454,476,358,2639
The Garden Shed,99,211,254,277,521,745,527,2634
Pergola Paddington,0,0,300,451,577,789,517,2634
TriumpH resto-lounge-shisha-garden,272,283,330,295,533,649,271,2633
Inn 1888 Pub & Scullery,231,366,447,604,627,358,0,2633
Mikkeller Brewpub London,111,221,337,471,650,641,202,2633
Old King's Head,210,325,540,649,552,357,0,2633
MEATliquor,216,239,334,416,553,664,211,2633
Cocochan,185,289,375,351,528,643,260,2631
The Drop Wine Bar,0,241,324,376,417,812,461,2631
Ashburnham Arms,229,405,289,390,352,459,507,2631
Vagabond,106,255,296,351,538,724,360,2630
BrewDog Brixton,258,258,299,345,422,775,272,2629
Vinegar Yard,110,178,272,463,475,818,313,2629
Pitch Golf London,468,548,292,580,432,308,0,2628
Goose Fulham,180,335,426,361,351,542,432,2627
The Back Room,271,218,380,392,503,587,274,2625
The Coat & Badge,175,201,275,304,458,848,363,2624
The Breakfast Club,290,256,237,310,377,625,529,2624
Costa Do Estoril,319,397,599,523,446,328,11,2623
The Angel,233,243,359,402,470,666,250,2623
The Crown,194,238,211,247,339,697,697,2623
Simmons Bar | Tottenham Court Road,97,259,291,393,578,618,384,2620
Hop Poles,159,284,380,444,647,465,238,2617
Browns Old Jewry,249,380,618,772,498,100,0,2617
St Swithins Wine Shippers,328,555,553,655,526,0,0,2617
The Alexander Hay,203,327,327,540,554,663,0,2614
The Old Star,230,392,499,640,451,218,183,2613
Eastcheap Records,95,268,390,651,583,551,75,2613
The Dolphin,191,240,414,372,617,456,323,2613
London Cocktail Club,161,258,306,500,643,744,0,2612
Lord Nelson,197,245,325,482,569,586,208,2612
Dog & Truck Stepney,192,350,516,530,455,358,211,2612
The Bletchley,0,0,305,277,565,1071,391,2609
The Shaston Arms,184,307,400,594,464,660,0,2609
The Ivy House,106,211,303,299,612,553,525,2609
The Tommyfield,218,335,321,503,465,441,325,2608
Stormbird,229,236,351,396,461,536,399,2608
Eve Bar Covent Garden,0,285,310,563,694,756,0,2608
People's Park Tavern,148,176,147,186,347,950,653,2607
Tom Cribb,185,285,398,483,413,745,97,2606
The Hunter S,103,191,192,254,467,789,609,2605
Sushi Salsa - Camden,276,247,311,301,370,594,505,2604
Market Tavern Shepherd Street W1,180,295,394,525,461,427,321,2603
The New Cross House,263,396,329,406,485,528,195,2602
The Morden Arms,265,240,151,488,423,366,668,2601
Riva Lounge & Restaurant,200,211,218,233,368,718,652,2600
Sir John Balcombe Marylebone,177,384,347,610,598,271,212,2599
Lady of The Grapes,20,194,316,420,461,816,372,2599
Caravaggio Italian Restaurant,288,159,279,387,516,594,375,2598
Clarendon Arms,137,394,432,416,455,430,333,2597
The Tap In,46,257,308,410,460,732,384,2597
The Crown London,177,259,338,247,398,702,476,2597
Plough Dulwich,166,140,275,419,419,518,658,2595
The Italian Job,0,0,326,337,485,709,738,2595
The Bill Murray,229,303,318,317,460,574,393,2594
The SpaceBar,338,246,357,354,452,554,291,2592
The Windmill Pub,337,424,434,683,712,0,0,2590
The Duke of Wellington,138,167,181,241,535,771,556,2589
Lord Raglan,188,363,511,684,584,186,71,2587
Bun House,0,302,346,381,410,717,430,2586
Crol and Co,232,298,404,395,325,441,490,2585
Oaka at the Mansion House,231,447,416,481,453,353,200,2581
Carpenters Arms London W1,193,414,497,575,608,272,21,2580
"Princess Victoria, Kensington",89,195,409,386,529,559,412,2579
The Merchant of Battersea,93,106,255,234,518,854,518,2578
Steam Wine Bar,110,578,511,862,517,0,0,2578
The Schoolhouse,0,135,192,350,533,897,470,2577
Phoenix Palace,273,259,262,313,382,537,551,2577
Bellaria Restaurant & Wine Bar,149,302,448,478,603,470,127,2577
Duchy Arms,111,159,415,527,343,579,441,2575
Williams Ale & Cider House,157,292,394,610,493,422,206,2574
Balcone London,264,208,299,566,311,447,478,2573
Hoxley & Porter,0,128,286,333,499,810,516,2572
Humble Grape Liverpool Street,222,257,471,541,540,541,0,2572
Young & Co's Ales & Stout,380,198,357,319,352,506,459,2571
Mucci's,0,309,290,277,459,752,482,2569
Hichki,200,289,390,398,396,316,579,2568
Lyaness,232,212,236,0,380,870,636,2566
Bodean's Tower,157,249,252,337,508,670,393,2566
Anokha Indian Bar & Restaurant,198,349,589,804,625,0,0,2565
Big Chill,84,122,213,361,526,806,452,2564
Dirty Martini St.Pauls,96,193,290,377,577,719,312,2564
Sir Colin Campbell,26,204,432,289,401,678,533,2563
Cheese + Fizz,0,0,344,514,661,810,234,2563
Bamboo by Alice,0,54,245,248,595,1013,407,2562
Sager + Wilde Restaurant,243,285,325,378,449,496,381,2557
Hagen & Hyde,223,184,230,335,498,707,379,2556
The Durell Arms,138,269,255,198,423,917,355,2555
Pratts and Payne,216,206,443,342,540,488,320,2555
TDQ Steaks,271,239,397,321,464,471,392,2555
'O Ver Borough - Italian Restaurant,0,0,436,400,481,686,552,2555
Amersham Arms,210,154,156,237,482,735,578,2552
The Perky Nel,112,205,136,243,451,849,555,2551
Perry Hill Pub,108,168,223,317,537,601,597,2551
Ye Olde London,147,289,315,616,436,488,259,2550
The Coopers Arms,161,211,306,283,418,593,577,2549
Wild by Tart,0,316,422,602,520,538,151,2549
Prosecco House,0,314,322,579,616,717,0,2548
Birdcage,123,153,366,228,426,536,716,2548
Simmons Bar | Piccadilly Circus,177,241,353,427,572,568,208,2546
The Bird in Hand,0,333,332,366,473,600,441,2545
The Speaker,238,359,513,658,455,248,73,2544
The Last Talisman,0,175,320,440,482,742,385,2544
Old Fountain,154,329,465,539,473,402,180,2542
Hookah Lounge,147,207,110,281,408,850,539,2542
Kill the Cat,0,97,380,359,690,723,293,2542
Sycamore Vino Cucina,302,315,337,439,461,580,106,2540
SatayBar,277,222,290,331,504,556,360,2540
MEATliquor N1,225,253,272,382,502,638,268,2540
Tomahawk Steakhouse Hoxton,160,223,328,418,536,581,294,2540
Scarfes Bar,0,361,445,571,472,632,58,2539
Frequency,532,447,455,629,476,0,0,2539
Maria's Tortilla,326,0,402,382,566,582,281,2539
"The Iron Duke, Mayfair",196,345,439,506,428,624,0,2538
Easton Clerkenwell,200,312,466,654,444,321,140,2537
Bar Américain,166,375,363,423,526,514,170,2537
The Whiskey Tumbler,0,249,300,474,441,628,444,2536
Coin Laundry,121,188,346,443,591,592,255,2536
Simmons Bar | Liverpool Street,143,211,327,447,555,566,287,2536
Kaki,313,245,287,375,392,515,408,2535
Petitou,316,321,327,398,305,458,409,2534
The Rake,217,327,291,391,500,615,192,2533
Louie,0,400,439,581,561,500,52,2533
The Woodstock,236,282,216,301,505,767,223,2530
Jamon Jamon Soho,245,211,309,317,420,656,370,2528
The Devonshire Arms,174,186,185,276,548,774,384,2527
The Lucas Arms,90,219,450,516,575,526,151,2527
The Champion,182,345,321,491,465,666,56,2526
The Engle Field,57,175,247,353,524,739,431,2526
Salotto 31 Wine Bar & Restaurant,227,631,490,771,405,0,0,2524
The Colonel Fawcett,0,114,312,367,519,727,484,2523
Tequila Mockingbird Wimbledon,149,193,244,383,545,686,321,2521
The Woodman Pub,139,294,244,272,642,524,405,2520
"The Artillery Arms, EC1",178,288,371,576,538,267,302,2520
The Red Lion,336,396,495,714,577,0,0,2518
The Crown,230,232,270,372,451,735,227,2517
Lantana Shoreditch,245,223,360,403,394,482,409,2516
Bloomsbury Tavern,166,312,405,431,473,728,0,2515
Zaika,141,299,371,360,519,478,346,2514
The Portman,178,305,401,536,367,452,271,2510
Humble Grape Islington,250,209,287,417,474,525,348,2510
Willys Wine Bar,219,487,573,763,468,0,0,2510
"Rose & Crown, Pub",201,195,222,324,506,537,524,2509
London Cocktail Club - Shaftesbury Avenue,102,152,200,541,559,786,169,2509
Sixes Cricket Club,0,231,273,481,477,437,609,2508
Han Kang,303,305,410,402,517,534,35,2506
Broadway Bar and Grill,192,190,356,253,420,649,445,2505
Frequency Coffee Angel,306,367,278,274,301,466,513,2505
The Craft Beer Co. Limehouse,151,215,271,399,610,488,371,2505
The Roundhouse,204,150,197,269,653,638,392,2503
The Mayfair Tavern,155,218,191,304,550,621,464,2503
Frederick's,0,401,519,444,481,657,0,2502
IRENE,0,0,358,472,632,529,511,2502
Rainbow Sports Bar,0,122,260,481,624,624,391,2502
The Pear Tree,139,200,312,290,430,692,438,2501
The Prince of Greenwich Pub,0,179,238,281,474,630,699,2501
Pearl Liang,221,259,301,316,387,525,490,2499
The Italian Greyhound,0,0,522,585,679,594,118,2498
ARCH Clapham,183,164,230,317,427,735,442,2498
The George and Monkey,133,263,300,515,447,617,223,2498
Old Bengal Bar,278,284,416,624,345,551,0,2498
The Ship & Whale,139,128,171,416,329,647,666,2496
The Eclectic Collection,301,169,225,409,439,499,453,2495
Mooshies,0,0,0,470,580,781,663,2494
The Grill Factory,354,389,102,293,314,618,423,2493
John The Unicorn,153,159,225,319,524,747,365,2492
Skehans,233,161,285,281,515,601,416,2492
Mala Indian Kitchen & Bar,0,379,359,448,509,447,349,2491
The Victoria,144,304,361,610,468,373,229,2489
24 The Oval,0,0,444,431,593,626,395,2489
Prince Regent,131,147,291,310,633,663,314,2489
HUCKSTER London,0,171,290,560,456,797,214,2488
Sambrook's Brewery,0,300,425,378,414,714,256,2487
Chesterfield Arms,269,214,424,393,479,383,325,2487
The George,27,245,345,364,648,803,55,2487
Be at One Islington,146,193,228,358,528,704,330,2487
Tower Tandoori Restaurant,266,324,296,354,410,546,291,2487
Be At One Berkeley Square,134,241,299,420,491,590,311,2486
Daffodil Mulligan,0,260,506,661,488,564,5,2484
Alcotraz Shoreditch: Cell Block Two-One-Two,0,145,175,395,481,916,372,2484
Prince Arthur,0,234,526,472,529,530,192,2483
Admiral Duncan,332,257,258,342,440,563,291,2483
Radicals & Victuallers,88,196,321,257,391,655,575,2483
The Dartmouth Castle,151,322,457,570,496,268,218,2482
Jamon Jamon Camden,184,215,215,298,458,679,431,2480
The Reliance,157,270,309,429,611,528,176,2480
The Rose & Crown,0,84,235,386,637,705,431,2478
Barcelona Tapas Bar & Restaurant,205,293,371,613,539,457,0,2478
Barcelona Tapas Bar & Restaurant,205,293,371,613,539,457,0,2478
The Bar,0,0,393,463,609,770,242,2477
Near & Far Camden,101,177,99,182,494,955,469,2477
The Oliver Conquest,134,216,220,463,519,450,475,2477
Maple Leaf,185,249,248,324,372,664,433,2475
The Brougham,157,376,80,202,375,808,477,2475
CITYROY London,361,538,352,744,480,0,0,2475
The Alexandra,125,173,180,291,399,923,381,2472
Eagle City Road Hoxton,173,325,524,456,542,281,171,2472
Voodoo Ray's - Peckham,208,159,209,390,537,527,441,2471
Bacari,345,625,540,710,250,0,0,2470
The Bricklayer’s Arms,108,181,460,264,492,500,462,2467
Ballie Ballerson,39,0,0,329,461,983,655,2467
The Queens Head,158,430,666,695,496,0,21,2466
Punch Tavern,0,344,423,562,474,663,0,2466
The Mews Bar,347,299,321,268,487,32,712,2466
Number 90 - Bar & Restaurant,40,158,159,288,564,875,380,2464
Dirty Martini - Monument,62,143,207,482,600,773,196,2463
Il Portico,275,384,461,409,436,497,0,2462
The Enterprise,122,325,385,606,546,478,0,2462
London Welsh Centre,295,441,497,533,374,321,0,2461
The Cat & Mutton,89,135,206,221,484,861,463,2459
Meridionale Restaurant,0,347,310,274,402,594,528,2455
The Monument,118,388,411,634,523,381,0,2455
"Vardo | Outdoor Dining, Takeaway & Coffee",229,287,306,348,301,694,283,2448
Osteria dell'Angolo,495,502,440,466,467,78,0,2448
Steak & Oysters,286,312,419,320,374,245,491,2447
The Cock Tavern,147,238,307,379,542,545,288,2446
Black Bear Burger - Restaurant Brixton,0,226,246,443,517,670,343,2445
"Yorkshire Grey, Fitzrovia",149,325,520,575,524,351,0,2444
The Paxton,134,183,197,261,588,530,551,2444
Lyle's,0,402,473,453,532,584,0,2444
La Rampa,104,200,390,492,544,713,0,2443
The Butcher's Hook,10,385,569,318,291,421,447,2441
The Castle,145,251,215,329,507,595,397,2439
Cocoro,0,438,502,413,533,552,0,2438
Louie's Hot Chicken,279,189,225,353,493,637,262,2438
Cottons Camden,101,168,170,172,489,876,461,2437
Patri Hammersmith,0,258,395,370,503,507,403,2436
The Lamb Tavern,192,375,448,692,427,209,93,2436
Freemasons Arms,193,200,344,408,370,746,173,2434
Railway Tavern London Sw4,159,193,279,404,515,618,265,2433
El Pastor Soho,0,188,466,540,538,496,204,2432
The Blue Legume,206,228,261,287,406,763,280,2431
Humble Grape,158,275,342,446,501,432,276,2430
Turner's Old Star,144,169,216,344,457,762,337,2429
Nag's Head,152,158,274,356,599,409,479,2427
Balham Bowls Club,117,157,270,281,481,725,395,2426
Rawshà,242,318,254,238,409,564,400,2425
Jak's Bar,203,235,264,377,438,537,370,2424
Est. India,279,288,400,438,362,371,284,2422
Cork & Bottle Wine Bar,49,307,402,412,593,658,0,2421
The Grafton Arms Pub & Rooms,190,361,484,668,487,230,0,2420
The Queens Head,177,251,411,529,517,535,0,2420
All Bar One Moorgate,138,263,360,661,623,375,0,2420
Walrus & Carpenter London Ec3,197,421,463,717,448,174,0,2420
Skylight Peckham,139,161,221,211,561,799,328,2420
The Lord Nelson,156,106,202,297,489,727,442,2419
Queens Arms London Sw7,233,320,337,351,461,429,287,2418
Horse & Groom,146,271,320,631,724,326,0,2418
O'neills Clapham,124,156,185,298,458,820,377,2418
Lima Floral,0,315,353,338,496,643,272,2417
Gigi’s Hoxton,5,182,212,309,398,941,370,2417
The Remedy Wine Bar Shop & Kitchen,0,455,425,577,494,465,0,2416
"The Telephone Exchange, London Bridge",94,282,368,594,605,471,0,2414
The Cocktail Trading Co. Brick Lane,158,238,290,270,412,757,289,2414
The Half Moon,255,176,270,343,452,528,388,2412
The Manor Tooting,115,176,271,387,545,579,339,2412
The Old Ship Stepney,154,192,301,361,530,496,378,2412
Heidi,0,227,281,283,415,888,317,2411
Vagabond Charlotte Street,0,246,348,554,541,721,0,2410
Lore of the Land,0,291,509,609,478,262,260,2409
The Flying Horse,174,307,447,605,463,412,0,2408
The Hide Bar,0,238,322,444,606,663,135,2408
The Widows Son,173,417,303,338,552,407,218,2408
Chequers Tavern,156,371,430,550,494,296,109,2406
Rude N Boomin,314,374,397,381,475,465,0,2406
TAB X TAB,0,0,485,465,368,552,535,2405
Red Lion,271,335,498,701,367,170,63,2405
Alexis Suya Grill & Bar,227,230,252,265,438,456,537,2405
The Social,267,342,312,469,439,509,66,2404
McGlynn's Free House,166,324,345,543,548,423,54,2403
Milroys Of Spitalfields,0,326,370,548,571,588,0,2403
The Waverley Arms,98,128,154,394,460,623,546,2403
East London Liquor Company,0,0,0,457,562,1012,372,2403
Be At One - Hammersmith,124,176,174,325,620,705,278,2402
Brio Tapas Bar & Restaurant,0,182,201,239,561,753,466,2402
Hamlet Bar Lounge & Restaurant,265,152,202,227,499,667,390,2402
The Rising Sun Lewisham,202,269,318,262,647,383,321,2402
The Tiger,133,163,276,208,415,713,493,2401
Red Lion,162,229,296,425,429,657,202,2400
Simmons Bar | Monument,75,159,224,454,655,664,169,2400
bronsbury snooker club,147,405,180,363,267,553,482,2397
The Eagle Ale House,188,198,291,314,547,570,287,2395
Beer Rebellion,169,237,295,353,649,501,190,2394
Adam & Eve,149,437,563,643,478,123,0,2393
The Duke of Cambridge,0,246,287,313,401,693,453,2393
Sutton Arms,214,269,448,611,495,200,155,2392
Wolfpack,178,175,236,344,522,582,354,2391
Sports Bar & Grill Clapham Junction,180,259,217,169,344,754,468,2391
Chi Noodle & Wine Bar,243,393,507,705,542,0,0,2390
White Lion Covent Garden,216,121,210,267,470,767,338,2389
Lucky Voice Karaoke Islington,142,161,187,275,400,818,405,2388
The Crown,112,302,248,407,567,469,282,2387
Barista - On the other side,289,332,510,383,313,325,234,2386
Above The Stag Theatre & Bar,0,249,339,380,382,624,412,2386
Bar Kick,77,143,214,257,380,916,398,2385
Hudsons,216,185,207,255,392,630,499,2384
Old Red Lion Theatre Pub,116,219,324,267,541,591,325,2383
Plateau,242,378,470,430,367,495,0,2382
Sotheby's Cafe,498,419,571,471,421,0,0,2380
Archer Street Soho,114,174,364,454,557,641,76,2380
Crown & Greyhound London,221,250,344,333,483,167,582,2380
London Shuffle Club,0,0,416,542,549,693,180,2380
"Wood House, Dulwich",176,176,225,279,347,592,585,2380
The Comedy Pub,121,165,416,335,396,729,217,2379
"Noura Restaurant, Mayfair",252,322,420,322,354,396,312,2378
Bleeding Heart Bistro,347,461,527,463,398,181,0,2377
Lissome,0,329,302,319,411,549,467,2377
The Rylston,243,146,338,400,213,494,542,2376
Destiny Italian Restaurant,220,380,280,381,436,304,375,2376
Netil Market,0,157,286,358,430,680,463,2374
London Beer Dispensary,149,215,254,354,589,503,310,2374
The Miller,131,201,335,461,603,605,36,2372
Birdies,0,0,0,322,639,859,551,2371
Royal Standard,15,159,335,402,537,441,481,2370
The Loft Wimbledon,259,267,353,351,529,441,169,2369
Crown & Castle,162,235,209,358,577,593,235,2369
Tanuki Gaming | Board Games,148,142,227,250,293,856,453,2369
Henry Addington Canary Wharf,182,263,355,598,542,337,92,2369
Freud Bar,138,208,191,313,488,727,303,2368
Jalisco,107,271,416,377,480,512,205,2368
BAR 31,0,0,284,295,601,888,300,2368
Bull in a China Shop - Bar & Restaurant,52,366,266,452,482,592,156,2366
The George,133,153,435,507,512,625,0,2365
Mamma Mia Ristorante Italiano,353,344,243,344,365,453,259,2361
The Sheaf,136,163,318,474,555,623,91,2360
Effra Social,135,235,191,320,566,570,341,2358
Tapping The Admiral,196,171,261,363,527,435,403,2356
The Foxglove Public House,157,170,393,405,408,553,270,2356
The Griffin,0,309,328,658,612,449,0,2356
The Feathers,185,319,445,535,371,277,223,2355
Balfour St Barts,191,309,447,689,715,0,0,2351
Planet of the Grapes - Leadenhall,0,698,609,633,411,0,0,2351
Lockhouse,196,361,444,674,431,244,0,2350
"The Hydrant, Monument",150,307,376,575,444,384,114,2350
Cellar Upstairs Folk Club the Calthorpe Arms,129,259,265,509,443,405,338,2348
Crown & Sceptre London W1,125,303,366,598,413,333,209,2347
Mercato Metropolitano,0,0,316,429,550,736,311,2342
The Jolly Gardeners,0,230,238,450,572,444,406,2340
Jazz Cafe,231,255,256,192,380,612,412,2338
Vault 139,345,239,224,549,299,357,325,2338
The Cuckoo N1,74,180,215,426,407,657,379,2338
The Four Thieves,143,187,236,307,411,806,247,2337
Earthsea - Cafe Restaurant,240,265,352,358,235,550,337,2337
Westland Coffee & Wine,334,416,458,694,433,0,0,2335
Farmer J,424,541,574,560,236,0,0,2335
Prince William Henry,0,310,354,613,611,446,0,2334
Souk,205,217,219,335,543,603,210,2332
The Hope Pub,157,181,307,252,601,350,484,2332
Waxy O'Connor's London,0,0,211,351,562,859,348,2331
London Cocktail Club - Goodge Street,61,215,242,390,545,656,220,2329
Nicholson's,230,225,282,512,359,485,236,2329
The Beehive,195,282,411,524,504,229,183,2328
Betsey Trotwood,188,196,415,574,630,300,25,2328
Amiga Restaurant,269,270,305,446,406,537,94,2327
Be At One Monument,119,183,229,318,536,664,278,2327
Enoteca da Luca - Guildhall,132,473,641,654,426,0,0,2326
North Sea Fish Restaurant,0,410,535,543,470,366,0,2324
Ant House,0,224,318,294,420,610,457,2323
Paul Tower 42,410,518,471,594,329,0,0,2322
"Ye Olde Mitre, Holborn",256,390,490,603,581,0,0,2320
Iberica Canary Wharf,156,270,306,438,394,609,147,2320
"Good Neighbour, Tooting",0,212,200,360,344,770,433,2319
Delaterra,0,160,218,389,445,588,519,2319
The Trading House,215,445,499,658,502,0,0,2319
The Kilburn Arms,298,330,372,514,0,39,763,2316
The Patio,317,418,423,374,424,360,0,2316
Elm Park Tavern,35,269,220,290,510,537,455,2316
Le Comptoir Robuchon,0,341,603,562,533,277,0,2316
FAM Bar & Kitchen,0,317,387,477,534,598,0,2313
The Blues Kitchen,129,186,212,208,379,770,429,2313
The Cut Bar & Restaurant,105,244,412,517,488,546,0,2312
The Leather Exchange,173,303,451,501,320,407,156,2311
Bons lounge,348,269,208,261,422,330,471,2309
Myddleton Arms,267,190,237,366,316,605,328,2309
Columbia Restaurant,340,5,248,278,350,490,597,2308
Vagabond Wines,141,309,384,630,488,355,0,2307
Schooner Bar,0,281,426,510,482,607,0,2306
The Rum Kitchen,175,180,206,204,575,680,286,2306
Lime Bar & Restaurant,128,305,277,393,340,500,360,2303
White Post. Bar Cafe Events,0,58,308,272,174,854,637,2303
The Wheatsheaf,114,250,369,553,536,480,0,2302
The Lady Ottoline,193,391,523,589,606,0,0,2302
Country House Earlsfield,170,210,284,335,539,517,246,2301
The Donovan Bar,0,394,451,492,525,301,138,2301
Karaoke Box Smithfield,54,143,283,404,553,710,154,2301
Nebula,0,489,188,314,468,554,288,2301
Moo Gastropub,0,158,270,431,548,661,231,2299
Old Street Brewery & Taproom Hackney Wick,42,94,217,269,542,768,367,2299
The Melody Restaurant,184,193,299,405,362,432,423,2298
The Bountiful Cow Public House & Dining,0,363,339,598,583,415,0,2298
Graveney and Meadow,140,88,144,242,691,661,331,2297
10° Sky Bar,0,0,229,475,729,777,87,2297
Ginger Lily,188,208,414,385,486,353,262,2296
The Jerusalem Tavern,234,361,511,571,618,0,0,2295
The Hoxton Seven,137,136,153,401,534,674,260,2295
The Leigham Well,155,198,230,461,391,490,369,2294
The Garratt & Gauge,141,151,216,278,610,619,278,2293
Strongroom Bar,61,99,191,454,587,714,187,2293
Power Station,380,398,424,474,412,204,0,2292
Tenshi,0,273,304,387,453,447,428,2292
Michael Nadra Brasserie & Takeaway Primrose Hill,0,0,314,380,497,546,554,2291
Factory House,0,538,516,923,312,0,0,2289
The Devonshire,111,158,154,245,509,794,316,2287
Haandi,225,193,370,350,398,444,303,2283
Antidote Wine Bar & Wine Shop,163,244,268,390,494,724,0,2283
The Clapham Tap,129,261,190,316,525,573,288,2282
Gordon Ramsay Bar & Grill - Park Walk,0,0,183,190,551,909,446,2279
Patara Thai Restaurant Oxford Circus,59,183,307,245,530,589,366,2279
Munich Cricket Club,27,259,256,568,525,644,0,2279
The Three Compasses,191,326,474,583,495,210,0,2279
Passione Vino,383,409,457,529,496,0,0,2274
Covent Garden Social Club,128,220,280,328,529,539,247,2271
BrewDog Old Street,227,308,491,769,476,0,0,2271
Bodean's BBQ Clapham,168,190,186,267,423,647,389,2270
The Harlequin,177,324,353,461,481,460,14,2270
Three Tuns Aldgate,139,320,462,672,426,251,0,2270
Barrio Shoreditch,128,140,172,318,464,727,320,2269
Slug & Lettuce Aldgate,111,169,271,556,656,504,0,2267
The Ship,194,172,317,405,432,407,339,2266
Beyzade Turkish Kitchen,184,169,246,281,405,510,470,2265
Globe London Ec2,203,333,439,625,455,210,0,2265
The Wandle,99,170,242,271,493,610,379,2264
The Woodman,140,162,198,247,576,478,463,2264
Brass Monkey,162,290,333,654,492,333,0,2264
The Alice,216,325,443,724,556,0,0,2264
Heist Bank,0,258,397,634,525,449,0,2263
temper City,56,362,621,767,457,0,0,2263
The Yellow Panda Pub Company,0,0,367,410,367,596,522,2262
Four Quarters Elephant Park,104,110,203,305,547,838,154,2261
The Atlas,36,201,299,365,354,636,367,2258
Firefly Bar & Thai Kitchen,162,210,274,262,548,526,276,2258
The Mere Scribbler,0,128,182,265,261,626,795,2257
Bermondsey Bierkeller,63,144,221,434,530,697,167,2256
The Beer Shop London,0,0,284,429,544,612,387,2256
Romulo Café & Restaurant,0,226,272,273,416,620,446,2253
BOTTLES,0,239,374,382,506,505,247,2253
Mamounia Lounge Mayfair,273,420,345,293,315,371,235,2252
Yeotown Sussex Gardens,110,161,251,215,387,508,619,2251
"Monarchy, Camden",186,198,272,209,309,726,350,2250
Nordic Bar,115,143,212,292,524,688,276,2250
The White Horse,141,177,278,340,415,742,157,2250
"The Viktor Wynd Museum of Curiosities, Fine Art & UnNatural History",0,0,215,297,475,819,443,2249
The Potting Shed,202,200,510,695,315,281,45,2248
Ping Pong Bow Bells House,238,408,471,639,491,0,0,2247
The Glasshouse Stores,187,224,323,473,420,610,8,2245
Duke of Clarence,143,149,169,323,432,654,374,2244
The Anglesea Arms,97,170,273,309,512,579,304,2244
The Angel,230,447,282,690,593,0,0,2242
Bishops Finger,324,354,505,586,472,0,0,2241
The Macbeth,109,409,123,232,362,575,431,2241
Galaxy Restaurant and Karaoke,188,16,183,196,385,753,519,2240
The Two Towers,318,126,229,347,415,424,381,2240
Fugitive Motel,0,0,254,341,522,843,280,2240
Greencoat Boy,202,252,381,632,414,193,165,2239
Duke Of Somerset,119,319,394,620,532,255,0,2239
Vintage Wines & Spirits,184,160,452,253,321,705,164,2239
Waxy's Little Sister,164,157,250,230,428,744,266,2239
Core Bar,82,157,338,642,627,392,0,2238
Rupert Street Bar,127,175,204,280,459,711,282,2238
La Ferme London,0,0,308,341,516,702,370,2237
Shepherd Market Wine House,372,0,596,556,0,712,0,2236
Pizza Tribe,179,317,566,617,557,0,0,2236
The Beehive Pub,176,290,316,476,558,394,25,2235
Mug House,0,525,311,534,490,375,0,2235
The Earl of Lonsdale,179,137,163,162,397,801,392,2231
Slim Jim's Liquor Store,159,196,203,300,480,591,302,2231
Priory Tavern Kilburn,160,168,268,340,569,421,303,2229
The Beehive,48,212,298,282,447,608,334,2229
West London Wine School,288,414,528,635,362,0,0,2227
The Duke,153,187,347,568,500,471,0,2226
"The Fence, Farringdon",169,330,436,676,442,171,0,2224
Three Little Birds,0,0,205,215,516,842,445,2223
Bow Wine Vaults,160,339,535,797,392,0,0,2223
Farr's Dalston,161,240,251,230,507,651,183,2223
Artist Residence Clubhouse,242,168,212,308,298,466,528,2222
Buckingham Arms,191,359,481,571,339,177,103,2221
Diogenes The Dog,0,159,244,336,525,647,309,2220
Rosemary Branch,94,126,219,232,547,616,385,2219
The Queens Arms,299,150,404,137,524,488,216,2218
The Wickham Arms,96,204,143,257,360,759,399,2218
Caravela Restaurant,0,174,284,223,373,628,535,2217
BrewDog Clerkenwell,187,332,450,507,411,330,0,2217
The Victoria,0,184,490,310,428,505,300,2217
The World's End,126,135,169,176,465,886,259,2216
Sea Horse Fleet Street London,125,160,231,515,398,595,192,2216
The Beehive,214,184,178,211,517,662,250,2216
Patara Thai Restaurant Wimbledon,126,259,303,322,566,461,177,2214
Ramble Inn,170,189,203,403,340,358,551,2214
Bocas,0,202,342,609,580,480,0,2213
Natural Kitchen,201,414,511,743,344,0,0,2213
Brawn,208,288,445,363,428,481,0,2213
The Running Horse,184,224,335,529,470,323,148,2213
Brydges Place Club,0,545,528,417,312,400,11,2213
The General Napier,469,115,322,302,546,309,149,2212
Vagabond Fulham,0,268,328,356,391,568,300,2211
Tasting Italy - Italian Restaurant,0,230,316,332,397,591,345,2211
Jamies St Mary at Hill,88,330,731,667,395,0,0,2211
Westminster Arms,214,425,474,637,459,0,0,2209
The Telegraph at The Earl of Derby,177,187,210,440,363,585,246,2208
Bandol,0,0,159,394,593,638,420,2204
George Canning,341,194,275,297,577,335,185,2204
Hisar Restaurant,227,216,216,192,472,563,318,2204
HIVE Selfridges,412,278,318,206,330,347,312,2203
The Westbourne,0,0,258,370,530,647,397,2202
Boqueria,0,0,227,244,320,701,710,2202
Champagne+Fromage - Greenwich,0,0,173,275,517,686,551,2202
The Talbot,0,147,190,230,437,552,645,2201
The Prince Arthur,79,124,186,247,484,512,569,2201
Palette Restaurant,208,147,401,760,254,319,110,2199
"Chaps Den Barbers (Hair Cut, Hairdressers, Barbers, Clapham Junction, Wandsworth)",242,227,246,475,478,299,231,2198
"The Pavilion End, St Paul's",126,306,459,628,435,243,0,2197
DUCKSOUP,0,256,397,377,492,533,142,2197
Limin' Beach Club,89,133,205,246,353,736,434,2196
Fogo de Chão Brazilian Steakhouse,188,226,184,203,481,595,318,2195
The Oak W2,0,165,271,251,399,707,401,2194
Café Deco,0,380,455,404,474,481,0,2194
Three Kings Clerkenwell,173,228,333,602,481,310,64,2191
The Escapologist,112,205,290,303,453,674,154,2191
Bar 190,249,216,197,238,488,533,269,2190
No. Fifty Cheyne,0,0,305,286,638,634,327,2190
Ye Olde Watling London Ec4,156,297,430,641,465,201,0,2190
Revolution London - Putney,147,152,205,248,483,661,293,2189
Vagabond Paddington,0,248,270,417,429,603,221,2188
The Globe,123,297,390,540,504,161,172,2187
Craft House London,0,271,199,360,580,718,59,2187
The Fat Walrus,0,0,250,284,516,751,385,2186
Retro Bar,116,188,282,363,432,592,212,2185
Notes Coffee Roasters & Bar | Victoria,135,320,384,332,256,435,322,2184
Dar Marrakesh,225,188,287,286,370,508,318,2182
FishbowlBrixton,0,219,287,281,349,693,353,2182
Well Street Pizza Hackney,165,177,242,218,396,558,422,2178
Friday's Pub,307,255,271,289,411,482,163,2178
Ganymede SW1,0,318,470,365,641,382,0,2176
G-A-Y Bar,238,215,236,301,394,515,277,2176
The Pregnant Man,111,478,452,630,505,0,0,2176
The Lexington,143,147,200,222,435,576,453,2176
Mr Fogg's House of Botanicals,0,0,277,350,605,884,58,2174
The Craft Beer Co. Clerkenwell,247,321,459,653,493,0,0,2173
Granaio Piccadilly - Italian Restaurant,0,0,0,0,753,793,627,2173
100 Wardour Street,0,0,0,349,514,979,329,2171
The Big Red,0,0,335,350,260,620,605,2170
The Pineapple,193,189,347,246,627,347,219,2168
Sugar Loaf,167,323,443,660,574,0,0,2167
Walkers of Whitehall,165,257,276,580,346,541,0,2165
The Thirsty Scholar,117,240,198,469,575,409,156,2164
Munich Cricket Club,100,201,294,509,455,499,106,2164
The Yard Bar,140,203,241,286,449,651,192,2162
Sir Richard Steele Pub and Dining,51,109,304,228,375,630,464,2161
Vasco & Piero's Pavilion Italian Restaurant,0,442,542,390,548,239,0,2161
Lima,0,338,374,484,411,554,0,2161
Eleanor Arms,219,304,267,392,0,457,521,2160
Green Bar,33,283,315,307,530,625,65,2158
Daisy,0,313,227,359,356,417,485,2157
"The Sutton Arms, EC1",228,392,334,570,447,186,0,2157
TCR Bar,155,322,337,573,519,249,0,2155
Three Eight Four,138,152,258,239,492,832,44,2155
The Black Prince,119,152,191,254,325,468,645,2154
The Glory,126,120,155,295,360,586,512,2154
The Colton Arms,172,194,215,349,441,440,342,2153
Albertine,0,332,362,479,514,465,0,2152
College Arms,261,528,313,392,462,186,10,2152
Three Cranes,247,376,483,648,398,0,0,2152
The Edgar Wallace,195,376,458,608,513,0,0,2150
Zayna,0,391,355,316,362,424,300,2148
STOCKTON,0,0,113,282,481,845,426,2147
Manor Arms,170,175,176,151,526,539,410,2147
BrewDog Clapham Junction,176,151,235,291,489,654,150,2146
The Earl Ferrers,0,284,150,302,437,671,300,2144
"Old Bell Tavern, Fleet St London",293,342,401,563,498,47,0,2144
The Black Heart,100,144,227,240,403,737,292,2143
"The Bay and Bracket, Victoria",145,214,368,556,378,300,182,2143
Simmons Bar | Temple,89,157,271,364,616,587,59,2143
Cabana,229,197,230,316,368,685,117,2142
Decimo,0,0,341,376,649,706,69,2141
The Colby Arms,138,110,174,288,608,458,365,2141
Railway Telegraph,132,217,193,331,388,549,331,2141
The Queen Charlotte,0,0,364,500,685,592,0,2141
Black Parrot,0,291,386,508,443,513,0,2141
Wimbledon tapas,0,232,354,311,684,276,283,2140
The 40 Elephants Bar,286,270,186,222,472,412,292,2140
Flat Iron Square,0,175,278,397,522,639,128,2139
Hijingo Bingo,0,0,276,342,456,733,331,2138
Louche Soho,36,122,249,385,518,641,187,2138
Noizé,0,340,404,505,524,363,0,2136
The Libertine,62,323,529,516,346,358,0,2134
Camino Monument,214,395,483,695,347,0,0,2134
The Prince,0,0,300,356,525,705,246,2132
The Union Jack,235,209,339,576,411,309,53,2132
Barrio Soho,0,135,265,430,511,718,71,2130
Coal Hole Strand London Wc2,161,203,275,267,334,598,292,2130
Anspach & Hobday: The Pigeon,0,248,334,395,582,571,0,2130
113 Restaurant & Bar,419,507,349,396,457,0,0,2128
Blade Soho,0,0,473,517,451,685,0,2126
Cubé - Japanese tapas and sushi fine dining,273,287,324,231,418,427,161,2121
Basement Sate,145,166,217,330,395,578,288,2119
The Bridge Clapham,63,249,342,259,444,521,238,2116
Four Hundred Rabbits: Pizza Restaurant Elephant & Castle,0,342,349,309,447,450,219,2116
Vine Bar London,329,311,381,467,377,249,0,2114
The Joint,0,0,300,249,518,677,369,2113
Burlock Rum Room,0,56,230,371,474,808,173,2112
Friendly Society,144,198,242,267,441,643,176,2111
Homeboy Bar - Islington,101,127,199,273,477,631,302,2110
Blind Spot London,0,0,401,528,550,558,73,2110
Migue's Latin Burger,258,314,223,293,473,547,0,2108
Cafe del Marsh,146,312,319,348,495,487,0,2107
The Crooked Well,0,112,188,221,495,580,511,2107
The Argyle,134,300,448,699,367,157,0,2105
TT Liquor,0,174,295,350,594,632,57,2102
The Royal Oak,105,164,449,233,296,473,382,2102
Best mangal Fulham,214,252,216,216,428,363,412,2101
Dover Castle Bar,109,211,351,297,409,388,336,2101
Green Shepherds Bush,188,201,245,287,422,481,276,2100
The Blind Pig at Social Eating House,0,259,304,394,510,581,51,2099
Trisha's,65,155,328,407,493,387,264,2099
Mrs Fogg’s Dockside Drinkery & Distillery,0,0,458,510,492,638,0,2098
Seething Lane Tap,0,0,443,638,487,530,0,2098
Whelan's,174,166,238,151,528,564,277,2098
BOTTLES,0,0,258,365,434,685,355,2097
Porky's & Play,0,0,185,460,466,833,153,2097
Village 512,136,190,144,195,218,660,554,2097
Broadleaf,81,292,430,596,353,339,3,2094
The Landor,95,122,175,259,574,625,241,2091
Champagne Route,143,300,335,289,387,536,101,2091
Antipode,233,227,215,242,219,473,481,2090
Roadtrip & The Workshop,0,92,147,240,550,682,379,2090
Tattoo Society,0,0,478,390,675,306,241,2090
Windmill Brixton,209,214,142,284,404,485,351,2089
"Courtyard Theatre, London",213,372,380,224,242,448,207,2086
Black Rock,0,265,274,464,491,549,42,2085
"The Conductor, Farringdon",167,388,470,664,395,0,0,2084
Orbit Beers Brewery & Taproom,0,0,289,299,514,568,414,2084
Mother Kelly’s Bethnal Green,0,159,239,277,551,686,169,2081
@ Bar,79,35,107,340,521,493,505,2080
Tito's,144,130,136,245,370,593,460,2078
Meathouse London,179,191,216,305,448,508,231,2078
Mango Indian,150,313,315,356,394,335,215,2078
Oeno House,345,450,501,423,359,0,0,2078
Ffiona's,0,153,170,281,284,696,488,2072
Hawkins Forge Battersea,103,102,168,299,358,762,279,2071
Gipsy Hill Brewing Company - Taproom,0,0,182,353,491,802,243,2071
London Cheesemongers,430,0,0,590,510,540,0,2070
BOB's Lobster Wine Bar & Kitchen,0,230,390,344,546,558,0,2068
Bricklayers Arms,152,211,295,522,462,426,0,2068
Experimental Cocktail Club Chinatown,0,0,240,323,453,635,416,2067
Platform,0,0,236,376,348,741,366,2067
The Hanover Arms,66,384,336,508,459,216,95,2064
Villages,0,0,0,383,422,823,436,2064
The Saxon,0,95,160,216,436,738,417,2062
Juno Rooms,0,271,382,644,485,278,0,2060
The Edge Shoreditch Beer Garden,66,144,198,441,512,593,106,2060
The King & Queen,175,257,342,590,385,310,0,2059
BloomsYard - Liverpool St,272,362,519,433,472,0,0,2058
The Wine Library,0,532,354,646,524,0,0,2056
Bishop’s,168,87,171,551,333,512,233,2055
The Old Sergeant Pub,0,162,206,285,406,649,347,2055
Lotus Bar,136,121,186,230,333,597,452,2055
Spice Merchants Indian Restaurant,152,308,299,308,265,420,300,2052
Bermondsey Arts Club,109,140,229,294,465,535,278,2050
Il Baretto,0,237,308,316,641,542,2,2046
The Thornhill Arms,0,267,498,281,356,394,250,2046
Simmons Bar | Angel,110,118,174,211,435,614,383,2045
Oblix,157,151,395,312,411,321,298,2045
Nori Sushi Bar & Grill,0,213,415,352,551,376,138,2045
The Wellington Fulham,0,173,367,138,226,568,571,2043
Bar Douro London Bridge,0,249,257,450,466,621,0,2043
Nine Lives,0,207,312,422,480,622,0,2043
The Effra Hall tavern,75,76,322,470,338,489,272,2042
The Barley Mow,126,234,319,403,508,452,0,2042
Il Trillo Ristorante & Giardino,0,146,202,281,348,642,422,2041
Thai Square,183,170,270,218,381,573,245,2040
Balls Brothers Minster Court,153,228,501,738,420,0,0,2040
Trattoria Verdi,240,213,375,351,267,474,116,2036
"Le Bar - Cocktails, Wine & Bistro",0,430,608,474,524,0,0,2036
North Pole Bar and Grill,138,177,166,178,471,573,333,2036
The Earl Spencer,0,0,256,283,435,599,462,2035
PINCH,0,381,516,586,330,222,0,2035
Akari,0,181,246,297,367,590,354,2035
All Inn One Pub,158,227,160,288,493,487,222,2035
Ninety One Living Room,0,147,199,290,422,687,289,2034
Number 25,210,446,499,609,269,0,0,2033
The Hemingway,113,174,187,168,275,520,595,2032
Heads + Tails,0,189,227,238,461,587,329,2031
Avenida Brasil UK,142,202,122,330,303,532,398,2029
Cheshire Cheese,208,316,454,582,469,0,0,2029
Editor's Tap,137,289,383,601,398,220,0,2028
Be At One - Liverpool Street,52,131,210,287,516,717,115,2028
Circa Soho,148,190,190,261,374,555,310,2028
"Vinothec Social - Pizzas, Wines, Cocktails & Craft Beers",172,206,270,319,531,504,24,2026
Ninth Life,0,102,196,196,422,735,372,2023
Dirty Martini Hanover Square,83,158,206,264,420,746,144,2021
Lockes - Covent Garden,79,142,227,298,472,700,101,2019
St Brides Tavern,200,351,429,633,405,0,0,2018
Be At One - Clapham Common,139,142,115,216,395,631,378,2016
Cafe Sol,56,100,102,214,512,703,329,2016
The Rebel Inn Streatham,196,132,205,230,579,412,262,2016
Colonel Saab,288,251,311,311,425,430,0,2016
Thai Square Covent Garden,0,171,323,386,451,514,170,2015
Ombra Bar & Restaurant,247,0,0,452,542,543,231,2015
The Nelson’s,0,152,256,208,295,568,535,2014
The Spurstowe Arms,112,117,217,259,507,576,225,2013
The Bowler Clerkenwell,125,148,321,596,373,207,241,2011
Old Street Records,88,149,189,281,486,632,186,2011
Two Chairmen,189,297,474,578,328,140,0,2006
Royal Court Bar & Kitchen,184,214,299,467,411,430,0,2005
Arts Theatre Club,0,100,262,361,466,580,236,2005
Horse & Groom,187,224,316,473,414,390,0,2004
SS Lounge,92,156,328,196,320,456,452,2000
Sambrook's Brewery Tap,0,180,294,294,418,640,171,1997
Flora Indica,0,292,294,330,281,527,273,1997
Kricket Brixton,200,226,270,318,491,485,6,1996
Kings Arms London,105,237,161,258,442,411,381,1995
Harry's Bar & Brasserie,0,612,535,396,413,38,0,1994
The Whitecross Tap,147,268,358,533,596,91,0,1993
Magpie Bishopsgate,143,321,412,630,487,0,0,1993
"The Duke of York, Fitzrovia",85,221,325,565,487,309,0,1992
The Camden Assembly Pub,82,174,129,203,327,763,313,1991
The Stage at The Londoner,40,0,270,0,320,750,610,1990
Joyce,0,168,276,319,513,476,238,1990
Bistrotheque,0,0,0,315,436,865,372,1988
Junction East,136,182,184,240,456,610,180,1988
Barrica Tapas Bar,0,184,344,339,576,543,0,1986
Sebright Arms,0,143,278,304,483,566,211,1985
Archer Street SW11,0,108,184,270,488,674,260,1984
The Duke of York Gastro Pub,43,298,379,328,421,395,120,1984
Harry Gordon's Bar & Kitchen,432,0,0,541,567,441,0,1981
Coal Rooms,73,68,166,214,329,571,558,1979
Tequila Mockingbird Clapham Junction,63,115,143,215,503,695,242,1976
Finch's,124,341,417,613,415,66,0,1976
The Jackalope,119,302,435,545,574,0,0,1975
Cottons Vauxhall,93,131,96,202,444,632,377,1975
"The Farrier Pub, Restaurant & Wine Store",0,0,212,299,406,669,387,1973
The Four Quarters,60,124,204,196,371,706,311,1972
Goat Clapham,93,135,234,304,452,629,124,1971
Singer Tavern,85,229,307,580,465,285,20,1971
New Noodle Bar (big Bowl Soup Noodle)(大碗麵）,0,441,308,407,477,338,0,1971
The Palm Tree,155,160,215,226,463,444,307,1970
DeGusto,0,0,188,226,356,480,719,1969
O Campino Restaurant,0,258,227,283,277,448,476,1969
Katzenjammers,47,96,179,406,514,636,91,1969
Rotate,0,405,258,623,683,0,0,1969
The Ship,118,303,588,629,326,0,0,1964
City University Club,376,393,388,388,414,0,0,1959
Angelus Restaurant,0,177,621,228,342,590,0,1958
Porky's BBQ Camden,0,0,0,270,392,755,538,1955
Volta do Mar,0,0,317,349,608,680,0,1954
Quarter Bar & Lounge,0,303,351,408,448,443,0,1953
Michael's BBQ Kitchen,0,514,941,432,30,30,3,1950
Job Centre,54,102,163,227,524,594,286,1950
Dogstar,0,97,207,197,372,636,440,1949
Old Doctor Butler's Head,162,347,404,604,430,0,0,1947
Fidelio Cafe,237,325,465,469,449,0,0,1945
The Rising Sun,203,238,376,602,353,139,34,1945
The Perseverance,126,177,182,183,263,664,346,1941
Rugby Tavern,15,186,451,567,391,330,0,1940
Little Ku,100,117,157,227,373,690,276,1940
Angolo Bar Restaurant & Pizzeria,0,200,184,412,350,526,264,1936
The Green,0,318,547,657,414,0,0,1936
The Frankfort Arms,115,133,196,202,540,349,399,1934
Forge,51,126,316,554,663,222,0,1932
Super Nature X SITE,0,119,299,287,308,462,457,1932
Zoo Bar & Club,192,141,157,131,323,578,409,1931
The Blue Lion,102,240,393,700,496,0,0,1931
City of London Distillery & Bar,163,316,319,326,317,490,0,1931
Zoo Too Bar,192,141,157,131,323,578,409,1931
The Square Pig,173,332,449,588,386,0,0,1928
Paddington Railway Club,267,0,0,163,265,483,749,1927
El Vino London Bridge,153,238,355,447,412,322,0,1927
Area 51 Limehouse,0,216,185,268,353,493,412,1927
Q Shoreditch,0,0,225,371,445,691,193,1925
The Stage Door Pub & Kitchen,91,215,279,447,351,480,61,1924
Wilton's Music Hall,183,271,325,351,372,422,0,1924
We Brought Beer,0,211,151,292,501,652,116,1923
The Railway Bell,93,206,172,213,484,510,245,1923
Deptford Does Art,0,0,446,307,281,489,400,1923
The Barley Mow,123,209,325,549,305,249,161,1921
The Last Tuesday Society,0,0,203,221,459,716,321,1920
The Hand and Shears,89,307,445,583,495,0,0,1919
Bertie's Bar,38,154,251,434,485,516,40,1918
Arman's kitchen,0,450,477,495,0,0,496,1918
Hunan,328,310,369,270,365,276,0,1918
DUO Shoreditch,0,0,144,328,574,870,0,1916
Humble Grape,154,174,223,341,512,414,96,1914
Simmons Bar | Farringdon,42,93,145,391,616,529,97,1913
The Duke of Edinburgh Pub | Brixton,74,137,196,184,388,699,234,1912
The Shakespeare,0,199,315,440,537,421,0,1912
Bluethroat Bar,0,0,365,380,485,680,0,1910
26 Furnival Street,73,331,612,638,255,0,0,1909
Paya & Horse Pub gallery,210,49,172,242,442,404,389,1908
The Queens Larder,136,226,215,354,551,279,147,1908
Balls Brothers Austin Friars,173,289,509,616,321,0,0,1908
Table @ Vallebona,0,189,175,308,319,576,340,1907
Brinkley's Kitchen,0,243,185,309,404,487,279,1907
Streatham Wine House,0,161,301,342,440,480,180,1904
Tootoomoo,203,278,137,169,363,368,385,1903
Donostia Restaurant,0,0,315,423,404,520,240,1902
Ciullosteria,144,261,200,232,383,359,321,1900
Curry Paradise Brixton,156,171,119,304,405,430,315,1900
Spread Eagle,86,93,114,166,404,601,436,1900
Bar Polski,0,239,355,524,577,204,0,1899
Pitcher & Piano Cornhill,120,290,419,614,414,33,9,1899
Thai Square Minories,285,328,477,397,412,0,0,1899
Trader Vic's,0,0,0,353,437,597,511,1898
East India Arms,187,400,423,535,353,0,0,1898
Found,0,216,254,512,426,435,55,1898
Be At One - Camden,83,99,104,160,489,689,273,1897
The Golden Fleece,148,270,443,638,397,0,0,1896
The One Tun Pub & Rooms,131,253,415,555,373,168,0,1895
Morso Abbey Road,0,0,254,290,337,616,397,1894
Amelie's Wine House,109,323,368,377,267,450,0,1894
Jack's Bar,0,269,330,557,443,295,0,1894
UNION,218,179,298,262,500,279,157,1893
Mother Kelly's Vauxhall,0,206,282,359,525,384,136,1892
Rudds,72,228,435,554,603,0,0,1892
The Florence,160,132,256,253,252,346,490,1889
The Gallery,0,0,268,379,524,543,173,1887
Bar Social,65,85,262,134,386,705,248,1885
Mango Tree,0,0,294,310,420,547,313,1884
Prince Arthur,0,196,307,463,496,309,112,1883
Happiness Forgets,158,224,252,280,409,361,199,1883
Be At One - Shoreditch,67,80,102,215,434,649,336,1883
Light House,128,208,246,324,393,355,228,1882
Cask & Glass,135,356,430,471,354,134,0,1880
Silver Lining,0,0,241,260,557,533,289,1880
The Yellow House,0,0,264,304,460,435,417,1880
Dream Bags Jaguar Shoes Shoreditch,69,141,158,294,430,545,241,1878
The Clerk & Well Pub & Rooms,27,249,545,458,563,35,0,1877
Jerome's Wine Bar & Shop,0,293,114,369,641,460,0,1877
Artesian,0,0,0,363,483,607,420,1873
Baccarat Bar,0,0,129,311,404,664,364,1872
Santa Maria del Sur,233,217,267,257,368,327,200,1869
Prince Alfred,0,137,179,257,488,583,222,1866
Nue Ground,111,239,257,214,124,483,438,1866
Bombay Palace,189,0,278,239,457,381,321,1865
The Bread & Roses,157,202,201,88,421,547,249,1865
Looking Glass Cocktail Club,0,146,231,308,397,514,269,1865
The Bell,0,129,267,587,532,345,0,1860
Alma's Restaurant Italian Cuisine & Pizzeria,0,228,288,258,348,521,216,1859
The Ship,134,231,378,519,595,0,0,1857
Issho-Ni Bethnal Green,0,0,394,389,504,567,0,1854
"The Swan Tavern, EC3",150,328,452,545,378,0,0,1853
The Resting Hare,159,361,367,488,477,0,0,1852
Old Gotham City,0,0,344,496,556,440,16,1852
Anchor Tap,0,101,223,412,568,538,6,1848
Brixton Brewery Tap Room,0,0,216,338,409,715,169,1847
Davy's Wine House,0,340,526,575,405,0,0,1846
Spanish Galleon,0,32,225,214,435,628,310,1844
Bohemia House,88,112,164,158,320,629,372,1843
Hugs and Bites | Mediterranean Tapas and Bar,0,333,265,441,388,416,0,1843
The Royal Oak,183,235,392,625,407,0,0,1842
Jam & Rye,440,146,115,202,340,420,179,1842
The Perseverance,240,271,282,455,516,75,0,1839
The Arab Boy,130,199,156,339,355,423,236,1838
Market Cafe Haggerston,113,103,146,175,267,609,425,1838
Viet Quan,262,214,227,175,318,638,0,1834
Lost Boys Pizza Camden,0,85,215,157,363,664,348,1832
Croque Monsieur Absinthe Bar - Camden,0,85,215,157,363,664,348,1832
Miss Tapas,0,0,217,230,378,650,355,1830
Cafe Isarn Take Away,198,164,191,291,380,377,227,1828
Paris Grill,232,380,447,478,291,0,0,1828
Royal Star,55,101,323,477,458,315,94,1823
City Lounge Bar,55,101,323,477,458,315,94,1823
NYEAT Restaurant & Cocktail Bar,0,0,130,204,427,667,394,1822
Cafe St Germain,0,150,218,329,277,378,470,1822
The Cornershop Bar,57,169,125,178,287,661,345,1822
The Hill,0,96,166,228,351,605,376,1822
The Craft Beer Co. Brixton,90,155,197,240,447,526,164,1819
The Gunmakers,223,314,425,506,351,0,0,1819
1920 Bar,0,0,278,509,454,577,0,1818
The Arbitrager,0,280,498,580,459,0,0,1817
Number Twelve,171,241,183,296,263,320,339,1813
The Chutney,193,197,251,286,323,395,167,1812
Gas Monkey Bar And Grill,0,0,262,201,625,493,227,1808
The Sultan,248,242,312,498,2,10,495,1807
BrewDog Chancery Lane,125,240,434,561,301,145,0,1806
The Ladybird Bar (Cocktail Bar & Club),70,88,136,142,288,654,427,1805
Ship Talbot Ct London Ec3,188,283,368,584,382,0,0,1805
Hector's,0,0,44,314,462,624,359,1803
The Garratt Tavern,149,143,187,198,179,484,461,1801
Revolution London - Leadenhall,97,158,209,415,455,366,100,1800
"The White Hart, Southwark",77,267,319,504,315,227,90,1799
Viet Grill,125,176,202,227,295,473,300,1798
Sir Sydney Smith,56,285,365,480,450,162,0,1798
Lounge at The John Salt,121,56,147,187,404,676,205,1796
Rise & Vine,118,90,180,255,541,452,158,1794
"Symposium | Wine Shop and Bar, Italian Deli & Restaurant",0,88,186,386,522,612,0,1794
Noorjahan II,0,295,311,301,289,373,223,1792
Royal Inn on the Park,129,140,131,147,272,486,487,1792
Artisan and Vine,0,168,198,359,509,293,260,1787
The Slaughtered Lamb,0,221,332,538,476,220,0,1787
The sl,0,221,332,538,476,220,0,1787
The Gardeners,0,66,250,286,628,405,144,1779
Baranis,0,312,445,304,392,326,0,1779
Constancia,0,208,215,194,281,541,337,1776
Strand Tandoori,151,112,287,269,301,485,170,1775
The Corner Pin,194,250,100,165,394,547,124,1774
17 on Sloane,161,230,225,345,217,336,258,1772
Tsunami,185,206,146,213,349,505,168,1772
Dragon Castle,184,138,104,215,264,459,408,1772
Flavours of Naples,0,272,229,329,561,380,0,1771
"The Tokenhouse, Moorgate",171,281,409,600,308,0,0,1769
Little Social,0,321,301,368,408,367,0,1765
Aphrodite Taverna,0,140,208,297,383,502,234,1764
Jamies Ludgate Hill,147,234,454,575,352,0,0,1762
Galvanisers Union,99,168,282,208,545,293,166,1761
Garlic & Shots,153,159,191,231,365,424,238,1761
"The Trinity Bell, EC3",95,295,450,636,284,0,0,1760
Sunset Bar,20,83,154,166,320,713,304,1760
Seasons Notting Hill Bistrot,0,0,285,467,448,318,241,1759
The Cannick Tapps,118,191,341,593,456,60,0,1759
The Fable,36,256,433,611,422,0,0,1758
The Institute Bar,207,275,289,394,592,0,0,1757
The Devereux,153,295,271,632,405,0,0,1756
El Inca Plebeyo Restaurant,109,107,215,126,426,486,287,1756
"The Rose & Crown, London Bridge (PUBLOVE)",38,237,308,514,396,250,12,1755
The Refinery Citypoint,63,269,343,575,504,0,0,1754
The Delhi Brasserie,162,185,183,219,287,531,187,1754
Phoenix Bar,54,138,134,237,303,482,405,1753
Vinarius,0,0,0,360,573,574,245,1752
All Bar One Appold St London,138,241,306,580,322,163,0,1750
El Vino Fleet Street,0,428,398,560,362,0,0,1748
The Kolossi,83,196,276,262,304,478,147,1746
The Tapas Room,0,207,262,286,487,503,0,1745
Devonshire Arms,0,218,308,504,356,358,0,1744
Tequila Mockingbird Shoreditch,49,149,89,207,404,615,225,1738
dion bar & restaurant,117,248,396,595,372,9,0,1737
Meat People,0,236,441,291,242,525,0,1735
Aaja Deptford,139,161,160,216,270,565,224,1735
BiFe,0,247,359,560,322,245,0,1733
The Guildford Arms,0,100,172,210,303,460,488,1733
Thai Square Putney Bridge,72,114,175,173,496,432,270,1732
Lechevalier Wine Bar & Shop,0,127,115,153,480,633,224,1732
Home Bar,0,224,385,413,427,281,0,1730
AMICI,167,252,48,136,165,493,463,1724
Guido's Grill - Latin-style Steakhouse,66,0,79,183,274,442,679,1723
The CLF Art Lounge & Roof Garden,0,0,155,204,458,649,254,1720
Cora Pearl Covent Garden,0,241,348,290,345,495,0,1719
Jamies Tudor Street,151,313,357,487,410,0,0,1718
The Grid - London's Sci-fi Cocktail Escape Experience,0,173,209,312,346,678,0,1718
Locanda Ottoemezzo,0,160,203,249,329,776,0,1717
Victoria Taps,0,186,155,586,424,155,209,1715
The Phoenix,125,288,362,557,381,0,0,1713
The Craft Beer Co. Hammersmith,0,201,219,389,443,460,0,1712
Salaam Namaste,0,324,236,234,378,307,233,1712
Meson Callejon,0,84,110,66,468,657,326,1711
67 Pizza - Italian Restaurant - Pizzeria - Lounge Bar,0,99,124,170,225,723,368,1709
The Moustache,0,0,0,233,428,528,518,1707
The Anchor & Hope,0,0,268,318,344,500,276,1706
Be At One - Shoe Lane,38,114,185,574,377,327,91,1706
Wood Street Bar & Restaurant,163,246,416,545,335,0,0,1705
Juju's Bar and Stage,0,79,205,200,321,374,524,1703
Royal Standard Bar,126,246,233,231,389,459,17,1701
"The Butchers Hook & Cleaver, EC1",161,233,328,564,414,0,0,1700
New Moon,76,215,319,553,292,234,11,1700
Kennedy's,1,1,233,507,297,374,285,1698
The Rabbit Hole,0,105,125,98,369,643,356,1696
The Cherry,98,296,227,212,546,206,111,1696
Compagnie des Vins Surnaturels Seven Dials,0,188,0,296,312,664,236,1696
Spit and Sawdust,69,188,172,194,428,534,110,1695
Humble Grape,0,337,526,463,368,0,0,1694
Mother Superior Wine Store & Deli,0,0,278,232,499,379,306,1694
The Mirror Bar,28,163,284,276,321,446,173,1691
The Three Lords,97,207,368,627,392,0,0,1691
Four Quarters East,76,100,151,174,315,678,196,1690
Pedler Good Fortune,0,0,186,177,395,662,269,1689
"The Telegraph, Moorgate",104,286,361,596,338,0,0,1685
The Lion Houndsditch,50,219,437,634,344,0,0,1684
The Centre Page,0,169,468,411,178,306,150,1682
Salvador & Amanda,45,106,118,184,314,646,267,1680
Thai Crystal,233,0,217,238,445,322,225,1680
Club49Soho,41,132,158,240,324,502,280,1677
Old Nick,62,199,413,597,405,0,0,1676
The Blacksmiths Arms,99,79,68,111,272,622,422,1673
TSQ Club,195,132,185,171,258,551,180,1672
Carmine SW16,0,179,158,275,413,605,42,1672
The Duke of York,106,331,293,328,279,225,108,1670
Bottle Bar and Shop,0,128,187,292,417,645,0,1669
OAT,250,297,399,350,373,0,0,1669
St James Bar,221,0,0,304,460,425,257,1667
Tacos + Tequila,0,187,167,316,467,509,19,1665
The White Onion,0,0,222,261,416,509,256,1664
Rack and Tenter,155,277,317,518,394,0,0,1661
BOXCAR Brewery & Taproom,0,0,219,346,453,483,160,1661
Royal Thai Restaurant,249,271,199,347,306,278,9,1659
Tank & Paddle,77,213,306,633,430,0,0,1659
The Beachcomber - House of Agricole Rhum,0,0,142,311,338,531,334,1656
The Grosvenor Arms,0,78,107,257,370,647,196,1655
THE 47 Balham,0,0,130,286,536,343,359,1654
The Refinery at Regent's Place,0,215,262,591,584,0,0,1652
El Chicos,125,127,156,186,443,378,237,1652
Two One Four,102,146,95,179,360,521,246,1649
Kitty Fisher's Mayfair,0,281,337,459,290,281,0,1648
Jerusalem Bar and Kitchen,0,0,194,279,424,599,152,1648
Temple Of Art & Music (TAM),98,102,183,225,386,395,259,1648
Matchstick Piehouse,6,175,362,217,301,452,135,1648
German Kraft Beer,0,0,211,386,441,609,0,1647
Morton's,162,254,191,319,497,138,85,1646
Meltdown London,569,167,180,164,319,56,190,1645
Barrio Brixton,0,0,64,101,349,801,329,1644
The Old Change Bar & Kitchen,227,138,278,488,361,152,0,1644
Firecracker Westminster,0,135,250,347,255,476,179,1642
Simmons Bar | Putney,79,71,75,182,372,627,235,1641
Hope & Anchor,74,179,171,258,321,419,219,1641
Le QuecumBar & Brasserie,0,388,138,315,181,308,310,1640
The Book Club,0,0,205,195,332,676,229,1637
Off The Cuff - OTC Bar,143,50,100,203,344,575,219,1634
The Last Drop,130,165,153,137,177,409,461,1632
temple of foo,0,174,338,594,345,157,24,1632
Kenza Restaurant & Lounge,111,202,258,291,446,323,0,1631
Renegade Urban Winery and Bar,0,0,151,170,327,760,223,1631
The Garden - Pizza Restaurant & Bar,0,177,264,296,352,541,0,1630
Spiritual Bar,17,160,165,214,414,489,170,1629
Juniper Kilburn,129,77,152,135,462,388,285,1628
Suchard,0,301,277,351,323,374,0,1626
Electrowerkz,0,58,51,105,246,519,646,1625
Goldsmiths SU Bar,0,505,58,548,513,0,0,1624
Cocktail Embassy,51,119,80,117,373,545,337,1622
THE BRICKSTONE,29,51,56,150,301,616,418,1621
The Full Nelson,103,127,197,219,225,525,222,1618
The Crown,83,166,295,511,559,0,0,1614
Babur,121,165,160,180,400,380,207,1613
Revolution,90,122,80,107,291,590,331,1611
The Skyline London,0,0,0,328,503,433,347,1611
Mere,0,388,302,351,279,287,0,1607
Friendship Adventure Brewery & Taproom,0,0,282,329,411,582,0,1604
Smokey Kudu,0,0,70,335,321,477,400,1603
New Street Wine,183,410,334,376,300,0,0,1603
SUPERMAX,0,0,188,410,511,453,38,1600
Gunpowder Tower Bridge,158,185,271,257,409,319,0,1599
baccalà,0,251,308,325,328,385,0,1597
Clarke's Restaurant,0,241,416,376,250,313,0,1596
Britannia Public House,49,78,132,448,289,372,228,1596
the windmill in the city,87,259,360,585,304,0,0,1595
Tequila Mockingbird Brixton,98,80,89,142,352,619,214,1594
The Nook,0,0,181,276,499,526,111,1593
606 Club,109,170,166,221,330,396,200,1592
Wroclove Restaurant,259,0,133,145,224,452,378,1591
Pasibrzuch Polski Bar,130,150,215,265,295,140,395,1590
Al Forno Shepherds Bush,0,224,226,221,311,368,239,1589
Bunghole Cellars,0,152,500,624,312,0,0,1588
Lost Society Putney,0,0,130,150,295,663,341,1579
The Craft Beer Co. St Mary Axe,76,241,403,536,323,0,0,1579
Jamies Adams Court,77,244,211,658,386,0,0,1576
Britannia,147,250,276,611,291,0,0,1575
Night Tales Loft,0,0,179,252,300,616,227,1574
The Sympathetic Ear,0,112,205,321,348,405,182,1573
12th Knot,0,0,0,468,508,536,57,1569
Mum Likes Thai Food (Restaurant/Takeaway/Bethnal Green),171,158,161,219,367,265,227,1568
The Huntley,195,239,358,401,373,0,0,1566
The George & Dragon Fitzrovia,0,379,317,526,341,0,0,1563
The Rising Sun,140,174,148,12,281,301,507,1563
Cafe Chula,0,0,0,261,359,558,383,1561
Brickfields Bar,0,150,187,259,504,459,0,1559
Crazy Coqs,127,187,162,323,255,304,200,1558
The Redchurch Bar,84,119,134,166,253,466,336,1558
Cottons Notting Hill,52,84,111,121,300,623,266,1557
Berber & Q - Grill House,0,161,249,253,373,406,115,1557
Locale Fulham,0,132,276,261,492,358,37,1556
The Windsor Castle,95,269,212,459,281,164,75,1555
TEMAKI,0,172,180,269,525,409,0,1555
Solstice St Paul's Riverside,0,0,227,237,247,401,443,1555
London Beer Factory - Barrel Project,0,0,183,215,389,661,106,1554
Ruby Blue,111,86,96,189,240,493,339,1554
Taberna Etrusca,73,334,405,459,257,18,7,1553
The Bootlegger,0,0,183,386,445,360,177,1551
The Hope,0,240,200,255,390,235,230,1550
Sway Bar,26,51,57,178,309,698,231,1550
The Commissary,48,63,218,255,483,440,42,1549
Two Brewers,72,82,111,140,212,485,445,1547
The Chapel,95,115,259,462,416,196,0,1543
Fox Fine Wines & Spirits,0,311,374,622,235,0,0,1542
The Queen Adelaide,55,58,123,131,341,526,306,1540
Bar 161,0,236,183,111,492,447,70,1539
The Melody Whisky Bar London,41,61,137,422,281,328,266,1536
"The Crown and Sugarloaf, Fleet Street",234,221,285,447,349,0,0,1536
Do Not Disturb (DND Bar),0,148,475,325,306,253,28,1535
Franklin’s Wine,0,0,465,296,521,250,0,1532
The Victory,126,120,270,264,324,381,47,1532
The Rabbit Hole,126,120,270,264,324,381,47,1532
Candelaria Latin Tapas Bar,0,186,206,318,369,452,0,1531
Green Man Marylebone,98,224,248,477,340,144,0,1531
The Three Tuns,76,280,344,504,326,0,0,1530
U7 Lounge,0,99,179,64,424,538,223,1527
The Bourbon,0,0,281,272,385,264,325,1527
Tapas Brindisa Shoreditch,0,0,0,238,366,647,276,1527
The Square Tavern,52,130,329,510,502,0,0,1523
Thai Square Strand,0,157,274,296,379,417,0,1523
Dame Alice Owen,119,165,406,340,486,0,0,1516
Rockwell,0,0,184,159,482,640,50,1515
The Bolthole,130,252,320,534,277,0,0,1513
Hood Streatham,0,0,211,223,383,409,286,1512
The Five Points Brewery & Taproom,0,0,0,280,472,757,0,1509
Prince of Wales,103,133,317,545,316,90,0,1504
Sugar Cane Bar,44,110,102,125,353,615,155,1504
Black Sheep Coffee & Cocktails,203,339,356,363,241,0,0,1502
The Henry Holland,104,171,241,225,360,312,86,1499
The Kings Head,0,25,61,75,327,619,390,1497
Craft Tooting,0,98,186,232,455,456,70,1497
Havanna,30,108,120,176,355,668,38,1495
"Prince of Wales, Brixton",0,81,108,123,291,544,347,1494
Bandra Bhai,0,0,200,312,416,532,33,1493
BYOC Camden,0,0,136,180,487,648,42,1493
All About Eve,0,100,85,207,390,587,122,1491
The Otherist,0,270,395,547,275,0,0,1487
Cattivo,0,0,78,102,324,890,92,1486
Simpsons Tavern,83,318,341,397,345,0,0,1484
Sky Pod Bar,0,139,218,245,377,402,102,1483
Viet Hoa Cafe & Mess,0,156,162,249,241,405,267,1480
Hattush | Mezze & Bar,106,10,223,216,417,504,0,1476
Phineas Bar,92,423,355,193,242,133,37,1475
El Vino Blackfriars,0,298,379,426,371,0,0,1474
Flor,0,0,0,277,390,418,389,1474
"Demon, Wise & Partners",0,222,340,485,425,0,0,1472
Trapeze Bar,0,0,0,195,310,663,300,1468
Green Parrot Lounge,0,0,213,160,401,539,153,1466
Williamsons Tav Groveld Ct Ec4,70,127,361,573,335,0,0,1466
The Grapes,105,262,325,532,239,0,0,1463
Masters Superfish,0,158,221,351,452,279,0,1461
Cheese at Leadenhall,0,279,328,578,276,0,0,1461
The Proofing Room,0,0,171,254,495,480,56,1456
Out Of Office,55,114,108,381,377,418,0,1453
Joe's,115,112,153,182,259,331,296,1448
The Fox,65,210,321,520,329,0,0,1445
Toulouse Lautrec,169,208,189,262,472,98,45,1443
The Vestry,0,0,248,493,365,332,0,1438
London Secret Beach,0,0,320,245,375,495,0,1435
Boqueria,0,0,144,174,397,446,274,1435
The Box - Caribbean Cuisine,164,114,78,139,248,535,154,1432
The Loose Box,74,235,318,479,255,68,0,1429
Senzala Creperie,202,392,565,8,93,154,15,1429
Geamos,0,0,394,364,334,336,0,1428
The Stanley Arms,0,0,0,317,148,770,193,1428
The Angel of Bow,0,0,195,227,571,435,0,1428
OPS Wines,0,174,210,187,599,0,256,1426
Loves Company,64,98,47,234,144,359,468,1414
Memsaab Indian Cuisine,65,83,132,137,394,349,254,1414
Benk&Bo,0,307,357,497,251,0,0,1412
Ambience Restaurant,51,231,200,120,379,257,172,1410
40FT Brewery & Taproom,0,0,0,158,309,943,0,1410
The Horseshoe,33,414,288,309,362,0,0,1406
Black Sheep Coffee & Cocktails,0,0,602,366,434,0,0,1402
Park's Edge Bar and Kitchen,0,0,161,165,367,452,249,1394
Newcomer Wines Dalston,0,25,144,210,421,594,0,1394
The Chocolate Cocktail Club & Cafe,0,0,126,355,319,591,0,1391
Barrio,0,0,72,119,322,648,229,1390
The Natural Philosopher,0,100,81,162,291,546,210,1390
The Lounge Bar at Palm Beach Mayfair,81,0,16,172,389,426,297,1381
Ev Bar,67,233,161,373,421,0,125,1380
Drapers Bar & Kitchen,212,225,376,303,263,0,0,1379
Palm Greens,230,177,272,166,213,318,0,1376
OSTERIA MBARE,0,0,196,276,387,298,218,1375
George IV,132,200,208,333,502,0,0,1375
Poulet,0,0,0,0,332,765,278,1375
73 Enid Street | Cloudwater London,0,0,117,125,241,691,200,1374
Paul Hamlyn Hall,124,149,202,229,236,431,0,1371
Cirque,29,37,42,113,364,572,207,1364
Blame Gloria - Clapham Junction,46,43,73,143,354,498,201,1358
El Vino The Olde Wine Shades,0,218,318,512,307,0,0,1355
Lazybones,0,0,543,471,338,0,0,1352
TOLA,0,17,63,141,308,479,340,1348
Buster Mantis,0,0,73,112,353,577,232,1347
Bar Pepito,49,139,221,430,289,204,13,1345
The Horse and Wig Pub,67,95,376,448,359,0,0,1345
Plonk Crazy Golf - London Fields,0,52,159,140,128,658,206,1343
The Green Room,0,127,411,252,253,300,0,1343
Millbank Spice,0,127,256,377,234,225,122,1341
Vagabond,0,0,417,485,439,0,0,1341
TikiTail Balham,0,53,320,75,280,380,232,1340
The Dolphin Tavern,51,221,182,579,306,0,0,1339
Romeo's Sugar Free Bakery,0,0,122,116,162,400,532,1332
Hammerton Brewery,0,0,0,198,578,555,0,1331
The Cumberland Arms,26,76,273,393,228,145,187,1328
El Vino Masons Avenue,0,257,286,599,185,0,0,1327
Cock & Woolpack,54,193,303,481,295,0,0,1326
Kanpai London Sake Brewery & Taproom,0,0,79,56,146,649,395,1325
The Rocketvan Coffee Shop and Bar,0,0,0,186,209,382,545,1322
Amora Gusto,91,116,94,183,246,412,170,1312
New Bloomsbury Set,0,0,238,390,478,202,0,1308
Cinnamon,0,216,158,232,423,200,76,1305
Escape Bar and Caribbean Tapas,73,54,45,209,251,484,184,1300
Trafik,39,60,85,127,253,515,217,1296
Putney wine bar & Kitchen,79,155,150,127,428,342,14,1295
Taproom By Brixton Village,0,0,95,183,384,509,118,1289
Percy's Kensington,0,0,0,155,437,466,228,1286
The Red Pepper,0,131,50,394,203,323,182,1283
Pasta Nostra,0,0,286,215,421,361,0,1283
Nam Long,27,24,88,217,283,423,219,1281
La Pizzica Restaurant,0,55,118,404,211,298,193,1279
Piazza Della Cucina,0,151,135,135,287,375,193,1276
The Bull & Finch,0,0,227,229,326,340,151,1273
The Savage Club,371,0,208,262,431,0,0,1272
Kricket White City,0,0,0,376,484,411,0,1271
Casanova & daughters,0,0,0,404,311,556,0,1271
Scarpetta - Cannon Street,159,287,334,286,205,0,0,1271
ESQ Bar,87,111,110,159,260,443,100,1270
The Newman Arms,0,207,297,443,275,47,0,1269
Hacha Brixton,0,0,186,230,397,454,0,1267
Thai Square Mansion House,212,227,210,420,197,0,0,1266
Distortion Brewing Company,0,0,0,140,511,477,132,1260
Stringray Globe Cafe,0,0,245,135,256,272,352,1260
Patch St. Paul's,0,158,248,499,352,0,0,1257
Wenlock and Essex,39,27,67,118,217,498,284,1250
Hing Lee Chinese Restaurant,0,138,135,197,326,341,112,1249
Muang Thai Restaurant,0,0,106,175,272,435,257,1245
The Chelsea Cellar,0,212,208,245,342,234,0,1241
Cargo,30,51,98,49,228,444,341,1241
Hawkes Cidery & Taproom,0,0,0,86,232,827,84,1229
Graveney Gin,0,0,0,178,512,440,98,1228
Light Of India,148,93,123,85,142,471,165,1227
Sorsi e Morsi - Pizza Restaurant Broadway Market Tooting,0,100,151,153,417,345,56,1222
Lamb and Trotter,0,200,313,456,253,0,0,1222
London Cocktail Club - Bethnal Green,0,50,151,71,262,646,39,1219
The Lucky Pig Cocktail Bar,0,0,183,116,305,465,147,1216
Vairavar Food & Wine,104,0,150,105,104,186,567,1216
The Lighthouse Bar & Kitchen,12,56,48,98,146,314,539,1213
The Wine Tasting Shop,0,49,105,264,357,329,105,1209
The Gobpsy,0,0,311,337,457,100,0,1205
Dan Angel,86,48,65,114,411,341,139,1204
The Tapas Room,0,70,101,227,409,393,0,1200
The Mercer,123,173,195,280,96,332,0,1199
BBC Club,118,186,183,200,498,5,8,1198
Melange Chocolate,0,0,0,207,167,327,490,1191
Simmons Bar | Leicester Square,0,105,212,170,236,382,86,1191
Kick n Munch Lounge,0,0,0,147,153,458,430,1188
White Shisha lounge,59,92,98,184,253,325,173,1184
The Ram Inn,0,0,121,218,220,489,131,1179
White Horse & Bower,113,162,188,478,237,0,0,1178
Cheshire Cheese,0,122,288,448,320,0,0,1178
Boulevard London,0,0,0,0,85,479,613,1177
Brick Lane Tap Room,0,0,0,107,354,581,134,1176
"The Shaws Booksellers, EC4",0,216,293,438,228,0,0,1175
Vinos y Licores,13,311,134,136,172,250,151,1167
"Beer Hawk Bar, Southbank",0,360,0,311,0,477,0,1148
#bsocial,7,65,5,0,200,574,296,1147
Coopers,0,331,287,266,261,0,0,1145
Mr Tipsy's: Down the Hatch!,0,0,34,229,322,512,36,1133
Mugen,111,203,256,290,204,63,0,1127
Sevilla Mia,0,53,52,111,283,428,197,1124
Popworld Watling Street,0,0,0,60,299,478,281,1118
"Bury Court, St Mary's Axe",0,190,274,578,74,0,0,1116
Piccolo Bar,173,207,185,228,287,28,0,1108
Porky's Wine Bar,117,122,193,64,111,282,216,1105
L'Oculto Cocina,0,0,218,144,353,312,78,1105
Metro Garden,0,0,0,0,266,386,446,1098
Flora Fine Wines,0,36,240,234,331,249,0,1090
Moonshine Saloon,0,0,52,76,214,743,0,1085
She Soho,0,0,101,99,271,441,167,1079
Magpie & Stump,0,119,174,477,304,0,0,1074
Sawyer and Gray London,0,0,118,91,125,362,378,1074
Sir Christopher Hatton Clerken,52,403,139,244,220,0,0,1058
Bayou Bar,0,0,185,145,372,347,0,1049
Bedales at Leadenhall,0,252,332,456,0,0,0,1040
Downstairs at The Dilly,0,0,385,109,96,398,50,1038
Erebuni Restaurant,79,0,0,160,234,469,90,1032
The Ancient Foresters,25,68,160,139,185,426,23,1026
The Outpost - Three Hills Brewing,62,26,55,61,182,615,25,1026
Brew By Numbers Tasting Room,0,0,52,35,171,678,89,1025
The Loop Bar,0,0,42,78,271,515,116,1022
Anspach & Hobday: The Arch House,0,0,0,63,185,698,68,1014
Bar @ 26 Leake Street,0,0,48,142,220,511,70,991
163 Upper Street,0,0,146,131,366,345,0,988
The Glitch Bar,0,0,99,67,133,618,42,959
Rock Steady Rum Lounge (Gipsy Hill),0,47,152,107,173,376,99,954
The Kernel Brewery Taproom (Arch 7),0,0,0,99,178,579,93,949
Tapster,0,97,169,525,152,0,0,943
TSQ Playhouse,0,0,0,0,394,475,74,943
The Doodle Bar,0,0,25,100,235,577,0,937
Albert's at Beaufort House,0,0,0,53,204,385,294,936
Bar Gansa,0,0,0,67,328,161,380,936
The Bell,69,53,85,89,209,279,132,916
Craft Beer Junction,0,0,0,0,94,690,103,887
Tooting Tram & Social,0,0,0,67,242,384,178,871
Southwark Brewing Company,0,99,0,117,176,476,0,868
Fourpure Brewing Co.,0,0,0,0,167,615,70,852
Dirty Habits,0,0,0,148,277,351,20,796
Fountain Tap,0,62,58,24,12,588,0,744
London City Runners,0,258,0,153,0,258,68,737
Neo Barbican,0,0,49,76,35,405,161,726
SIXTY/FOUR Cocktail Bar & Grill,0,0,20,12,70,348,272,722
