Name,Mon,Tue,Wed,Thu,Fri,Sat,Sun,Total
Spice Lodge,760,808,1028,1304,1084,948,632,6564
Tesco Express,920,981,899,917,839,794,919,6269
Little Waitrose & Partners Roehampton,854,896,933,865,815,811,824,5998
Virgin Active,880,950,959,913,779,851,600,5932
Tesco Superstore,894,899,860,891,849,860,492,5745
Sainsbury's,875,855,833,844,824,961,545,5737
Costcutter,849,861,844,771,873,940,429,5567
Premier,812,811,777,788,862,639,540,5229
premier express,912,822,786,699,653,651,567,5090
Subway,715,606,800,754,844,738,619,5076
Pearl Dental Clinic,769,645,692,600,712,854,739,5011
Dental,769,645,692,600,712,854,739,5011
Costa Coffee,638,710,806,898,771,645,439,4907
Asda Roehampton Superstore,689,707,697,732,762,821,475,4883
Co-op Roehampton Vale,732,707,778,832,876,460,265,4650
Co-op Food - Petrol Roehampton Vale,732,707,778,832,876,460,265,4650
Korea Foods,671,667,682,656,697,764,511,4648
David Lloyd Kingston,719,775,674,665,600,633,573,4639
Roehampton Supermarket,658,773,613,600,711,688,587,4630
Better Price,627,695,543,593,539,830,763,4590
Waitrose & Partners Twickenham,629,612,611,650,728,807,485,4522
Asda Kingston on Thames Supermarket,662,630,644,658,685,719,450,4448
Ivybridge Retail Park,704,731,695,669,726,910,0,4435
Cote - Richmond,445,499,524,609,623,991,738,4429
ESSO MFG ROBIN HOOD NORTH,641,710,694,738,679,528,367,4357
Euro Wines Premier,772,509,804,687,783,430,337,4322
Sainsbury's,634,581,625,639,623,763,424,4289
Goddard Veterinary Group Stone Lion Veterinary Hospital,598,723,963,515,646,360,422,4227
Londis,663,629,646,628,611,662,367,4206
William Hill,774,748,504,495,513,549,621,4204
Co-op Food - Raynes Park,604,579,590,577,608,557,686,4201
"Shaef Gate, Bushy Park",510,451,507,547,598,743,833,4189
Currie Motors Toyota Twickenham,738,749,739,768,687,331,81,4093
"Euro Car Parts, Kingston",651,760,798,768,603,437,0,4017
Kwik Fit - Kingston Upon Thames,464,569,555,726,640,729,289,3972
Royal Wimbledon Golf Club,442,442,659,702,587,621,494,3947
Marks and Spencer,513,531,541,555,528,740,430,3838
The Little Gym Hampton & Teddington,576,612,347,661,613,544,466,3819
Wimbledon Common Golf Club,553,694,561,666,583,717,0,3774
Going Swimmingly London,343,366,478,461,438,987,693,3766
"Royal Tennis Court, Hampton Court",332,512,372,684,352,832,640,3724
Cote - Wimbledon,373,456,377,394,569,803,734,3706
Furniture Village New Malden,576,500,584,511,378,714,437,3700
Curzon Richmond,357,425,471,518,495,827,582,3675
Johnstone's Decorating Centre,711,649,652,691,582,371,0,3656
Just The Ticket,648,784,641,666,624,269,0,3632
The Albion,186,402,417,484,709,773,635,3606
SPAR - Kingston Upon Thames,494,544,467,541,542,595,405,3588
The Mute Swan,270,296,317,393,640,916,749,3581
Partica Kingston,491,504,509,390,597,683,402,3576
Snappy Snaps,480,670,548,604,434,504,334,3574
Kwik Fit - Twickenham,554,526,643,543,498,530,272,3566
Gourmet Burger Kitchen (GBK),353,377,291,421,536,840,740,3558
Nando's Kingston upon Thames,334,411,414,405,507,801,673,3545
Mojo,547,460,428,732,483,465,415,3530
The King's Head,320,315,356,470,598,815,642,3516
Richmond Hill Bakery,407,399,453,433,462,707,650,3511
Bill's Richmond Restaurant,321,322,305,333,447,1004,747,3479
Hand in Hand,329,297,404,405,533,768,726,3462
Boots,492,480,486,553,454,649,310,3424
Triangle Dental Clinic,698,718,640,711,556,66,0,3389
Herbert & Shrive - Travel Clinic Teddington,616,730,457,586,598,381,0,3368
Primark,444,409,435,485,427,703,448,3351
Alsford Timber,582,640,699,688,514,223,0,3346
Mr Clutch Autocentres,733,477,576,540,513,507,0,3346
Grand Drive Surgery,664,704,710,709,559,0,0,3346
Medivet Twickenham,457,670,697,667,619,193,0,3303
Wimbledon Village Surgery,663,721,762,648,500,0,0,3294
Atariya Foods Kingston,0,560,642,522,571,589,404,3288
H Mart,398,395,380,436,472,774,416,3271
Mada Deli,0,374,488,457,493,662,729,3203
Patisserie Valerie - Kingston,412,464,448,652,468,472,284,3200
Three,576,447,356,553,454,397,412,3195
The Bishop,279,230,273,390,512,943,556,3183
Domino's Pizza - London - Kingston-Upon-Thames,461,431,357,324,609,622,352,3156
Five At The Bridge,411,312,468,378,355,589,591,3104
TONI&GUY Teddington,136,531,686,646,465,636,0,3100
Pets at Home New Malden,451,432,367,442,395,544,468,3099
Costa Coffee,503,371,545,387,370,388,529,3093
The Sussex Arms,219,211,316,346,595,836,544,3067
Mint Hairdressing and Beauty,0,704,697,551,455,658,0,3065
The Prince Of Wales,262,242,284,346,515,806,606,3061
East Chemist,411,522,582,578,580,364,0,3037
Ashburton Medipharmacy,608,570,662,594,496,105,0,3035
NEVILLE BARBERS,553,360,397,397,460,403,446,3016
Nakedhealth,690,381,565,399,651,281,18,2985
Danebury Avenue Post Office,574,563,494,572,578,167,0,2948
AJ Sports Kingston | Fordham,487,574,393,382,463,393,247,2939
DISH,408,276,370,347,291,594,649,2935
Ridgway Dental,453,557,562,662,455,216,0,2905
The Foresters Arms,211,193,232,384,626,601,614,2861
Kingston Hill Post Office,573,572,588,551,431,104,0,2819
Headmasters New Malden,665,243,489,446,414,559,0,2816
"The Prince Albert, Twickenham",202,222,301,375,571,814,320,2805
Roebuck,220,249,289,321,386,679,661,2805
Sheen Lawn Tennis & Squash Club,496,379,300,550,423,341,299,2788
Specialist Massage Therapies,581,564,640,573,368,59,0,2785
Pharmacare Pharmacy,456,487,638,583,435,181,0,2780
"The Anglers, Teddington",197,232,232,259,458,769,626,2773
Wimbledon Village Stables,0,450,562,535,515,356,355,2773
Kingston Vale Post Office,469,492,480,438,327,348,216,2770
LK Bennett - Bentalls,328,316,319,390,383,643,382,2761
The Teddington Arms,109,175,418,346,516,773,410,2747
Bluebird Care Richmond & Twickenham,465,578,613,587,499,0,0,2742
The Grey Horse - SMOK'D,221,226,378,364,510,637,400,2736
Howell Jones Solicitors,480,554,493,533,655,0,0,2715
Caesar's Camp,458,0,320,677,394,489,364,2702
The Cherrytree Dental Care - transform your smile with our digital technology,458,743,590,244,487,162,0,2684
Enterprise Car & Van Hire - Kingston,560,516,461,539,448,151,0,2675
River Island,300,298,288,442,360,584,371,2643
The Spring Grove,141,131,210,401,543,782,428,2636
Scribbler,391,437,239,379,365,580,238,2629
The Royal Oak,124,152,413,243,474,800,415,2621
Colicci Roehampton Gate Caf√©,279,246,215,275,256,653,686,2610
Goddard Veterinary Group Kingston,626,645,97,510,602,115,0,2595
The Lion,113,202,148,246,692,664,494,2559
The Marlborough,124,142,167,244,341,871,663,2552
The Norbiton,171,112,147,323,558,770,450,2531
Nationwide Building Society,613,479,429,511,329,130,0,2491
Zizzi,183,274,310,299,333,625,461,2485
RSPCA Monument Richmond,506,497,438,460,570,0,0,2471
Skipton Building Society - Kingston,471,476,435,547,538,0,0,2467
icon hairdressing,0,233,411,614,567,633,0,2458
Fratelli,278,429,484,322,421,506,0,2440
Holland & Barrett,424,0,424,627,416,542,0,2433
Pizza Express,181,240,276,287,339,649,460,2432
Genesis Capital Group,437,457,591,511,430,0,0,2426
Health On The Hill,539,412,465,420,334,251,0,2421
KANSET PHARMACY,488,419,633,389,274,213,0,2416
Buddhapadipa Temple,172,242,317,297,257,557,551,2393
Tucker French Surbiton,421,462,514,470,482,42,0,2391
Clarks,289,273,239,319,237,600,407,2364
Lloyds Bank,580,495,391,351,539,0,0,2356
White House Dental Practice,575,496,662,434,179,0,0,2346
HSBC Bank Plc,548,406,564,409,410,0,0,2337
Bar Estilo,222,227,253,271,400,605,331,2309
Yami Restaurant,166,217,138,252,242,657,631,2303
St Margarets Tavern,158,121,259,216,272,888,381,2295
Carbon Architecture Ltd,592,346,398,522,431,0,0,2289
BOSS Store,203,169,215,254,359,606,482,2288
Hampton Court Park (Home Park),0,0,446,441,325,479,586,2277
Pitcher & Piano Richmond,124,101,128,296,388,859,362,2258
LUSH Kingston,255,295,236,281,328,524,338,2257
Cotswold Outdoor Kingston Upon Thames,321,227,232,225,297,580,372,2254
Han Bar Restaurant & Karaoke,180,229,224,202,470,615,329,2249
The Cardinal Peppe Restaurant Kingston,0,100,156,130,417,800,645,2248
Richmond Music Trust,354,534,565,505,287,0,0,2245
The Eel Pie,101,189,207,304,419,734,275,2229
Lass O'Richmond Hill,178,227,136,226,313,554,581,2215
Surya Hot Yoga,291,251,338,228,158,445,427,2138
NakPhotography,221,230,312,420,346,333,248,2110
Richmond Vault Beer Cellar & Restaurant,0,136,203,235,399,732,403,2108
The Fox & Grapes Wimbledon,0,0,198,237,310,650,710,2105
Tangawizi Restaurant,0,260,267,312,446,468,333,2086
Roehampton Dental Care,590,370,429,317,324,0,0,2030
EKA Services Ltd,349,397,395,455,243,175,0,2014
Osteria Pulcinella,248,147,261,254,364,510,212,1996
Liles Morris Chartered Accountants,661,657,676,0,0,0,0,1994
CREATE Fertility,372,317,454,361,427,0,0,1931
Don Emilio,0,176,339,220,169,457,566,1927
Deea - Modern Indian Establishment,217,147,195,211,377,438,296,1881
Teddington Constitutional Club,145,189,310,232,458,335,209,1878
Joseph Hood Recreation Ground,180,171,226,200,174,555,327,1833
Westmoor Community Health Clinic,279,600,447,364,142,0,0,1832
Masaniello,0,253,126,271,269,639,260,1818
Forward House Hall,0,73,352,282,70,666,359,1802
Vanilla patisserie,176,174,143,220,230,403,379,1725
Crystal Chinese Takeaway,84,124,84,277,363,417,342,1691
Haxton & Co,591,321,490,284,0,0,0,1686
MATSUBA,0,181,198,277,499,522,0,1677
Three70 Bar & Shisha Lounge,132,269,132,347,296,479,0,1655
Twickenham Health Care,244,197,407,387,225,162,0,1622
The Good Earth Express,214,139,282,159,397,239,161,1591
Strawberry Hill House & Garden,355,479,462,0,0,0,291,1587
Boots Pharmacy,386,295,0,289,327,282,0,1579
Twickenham Tandoori,124,160,109,226,343,430,165,1557
Stag Lodge 2,0,304,216,0,239,313,458,1530
The Fox - Twickenham,61,44,85,132,340,741,124,1527
Roz Ana,121,109,168,170,360,400,184,1512
"The Cabbage Patch, Twickenham",37,71,103,131,231,825,111,1509
"The Turk's Head, Twickenham",61,130,111,112,243,685,146,1488
Aromaden Dental and Implant Clinic,444,208,280,383,173,0,0,1488
The Fountain Gallery,0,320,0,0,403,385,376,1484
The Entertainer,145,133,178,196,176,565,0,1393
Iris Hay Homeopathy,350,422,0,221,385,0,0,1378
The Fun Factory,0,380,223,0,314,424,0,1341
Light House,96,114,95,171,303,313,208,1300
Norbiton Sandwich Shop,247,173,230,290,333,0,0,1273
Richardson Evans Memorial Playing Fields,75,119,116,60,98,450,296,1214
Aquanaut Scuba & Snorkelling Centre,205,0,255,0,288,463,0,1211
Sai Restaurant,0,103,127,62,280,387,176,1135
World Rugby Museum & Twickenham Stadium Tours,0,202,169,49,58,465,30,973
Sheesh Mahal,25,11,45,48,275,403,42,849
Le Salon Priv√©,0,116,86,104,174,357,0,837
A Cena,0,28,65,107,169,352,0,721
"Holy Trinity Church, Roehampton",189,33,10,22,112,0,0,366
