Name,Mon,Tue,Wed,Thu,Fri,Sat,Sun,Total
SK Carriages | Available 24/7 in London| ðŸ‘‘,1683,1474,1342,1265,948,1629,1628,9969
wimbledon 3d printing,1425,1299,957,953,1236,1655,1379,8904
ubitricity Charging Station,1138,1101,1142,1369,1251,1384,1231,8616
International Music Univercity-UK,992,1079,1466,1067,1233,1365,1393,8595
Putney Community Orchard,1404,1260,1164,796,836,1316,1584,8360
ShockwaveVPS,1148,1137,988,1074,891,1128,1529,7895
Aerial Cars,1004,1141,943,1083,1084,1308,1125,7688
bp,958,1082,1160,1122,1182,1022,958,7484
Premier Express,891,969,1053,1029,1110,942,1144,7138
McDonald's,802,804,953,1045,979,1157,1031,6771
Spice Lodge,760,808,1028,1304,1084,948,632,6564
Tesco Express,944,945,1025,946,1012,879,792,6543
Sainsbury's Local,863,872,851,945,818,1017,1084,6450
Sainsbury's Local,922,902,1013,1074,985,805,696,6397
Hampton Court Station,801,888,933,1011,842,922,975,6372
Tesco Express,897,939,989,929,862,880,869,6365
Co-op Food - Kingston - Kings Road,859,959,943,970,914,836,865,6346
Tesco Express,920,981,899,917,839,794,919,6269
Tesco Express,899,924,963,917,830,826,859,6218
Best Kebabs & Pizza,889,788,851,858,887,819,1088,6180
bp,878,861,928,814,944,868,862,6155
Co-op Food - Teddington,828,852,909,895,935,847,867,6133
Anytime Fitness Raynes Park,1033,1129,987,851,702,700,608,6010
Little Waitrose & Partners Roehampton,854,896,933,865,815,811,824,5998
Hawks Local,907,900,976,960,851,701,694,5989
Jiffy,829,780,850,1007,740,1022,753,5981
Co-op Food - Twickenham - Hampton Road,764,796,920,898,736,876,954,5944
Virgin Active,880,950,959,913,779,851,600,5932
Shell,761,854,884,937,821,930,695,5882
Tesco Express,836,888,833,875,816,789,722,5759
Tesco Superstore,894,899,860,891,849,860,492,5745
Sainsbury's,875,855,833,844,824,961,545,5737
Co-op Food - Twickenham - Richmond Road,701,811,772,737,835,934,889,5679
The Ivy Cafe Wimbledon Village,735,697,746,707,877,926,978,5666
Norbiton (Stop NA),817,909,986,959,836,658,494,5659
Best-One,700,980,1040,450,550,980,940,5640
Shell,791,790,782,880,885,745,713,5586
Costcutter,849,861,844,771,873,940,429,5567
Waitrose & Partners New Malden,803,812,759,822,867,949,504,5516
Tesco Travel Money,796,766,756,834,841,998,510,5501
Tesco Extra,796,766,756,834,841,998,510,5501
"Spaces - New Malden, Tesco Beverley Way",796,766,756,834,841,998,510,5501
Tesco Express,751,786,789,864,801,868,635,5494
McDonald's,722,656,906,930,857,979,410,5460
Tasty Bite Pizza Bar,775,962,782,886,759,687,586,5437
Co-op Food - Wimbledon - Inner Park Road,761,686,723,827,910,813,645,5365
The Treestone Butchers,721,561,734,833,918,803,721,5291
Esso,689,898,788,791,703,738,651,5258
Londis,590,970,897,717,847,760,454,5235
Premier,812,811,777,788,862,639,540,5229
Ashburton Supermarket,763,829,968,780,756,517,582,5195
Londis,745,866,816,877,808,542,509,5163
ALDI,820,757,742,757,761,809,488,5134
Wimbledon Common War Memorial,672,731,724,862,654,653,823,5119
Lidl,752,669,693,762,760,937,518,5091
premier express,912,822,786,699,653,651,567,5090
Subway,715,606,800,754,844,738,619,5076
Turkish Supermarket Ada Food Centre(FREE CUSTOMER CAR PARK AT REAR),666,635,717,712,645,762,922,5059
Raynes Park Station ATM,670,876,943,926,687,545,383,5030
The Cardinal (Stop S),702,875,938,979,658,572,300,5024
The Cardinal,702,875,938,979,658,572,300,5024
Co-op Food - Kingston Lower Marsh Lane,746,826,777,675,650,654,691,5019
Tesco Petrol Station,697,661,612,753,759,801,730,5013
Pearl Dental Clinic,769,645,692,600,712,854,739,5011
Dental,769,645,692,600,712,854,739,5011
Bills food and wine,633,827,860,779,770,723,413,5005
M&S Simply Food,657,609,723,873,588,694,846,4990
NS Nithiya Stores,696,761,710,793,668,581,770,4979
Evri ParcelShop,781,498,985,1059,696,425,509,4953
Screwfix,829,838,926,922,791,434,207,4947
Suroor Market,610,679,613,718,720,875,703,4918
Starbucks Coffee,581,697,663,739,735,795,703,4913
Costa Coffee,638,710,806,898,771,645,439,4907
Asda Roehampton Superstore,689,707,697,732,762,821,475,4883
Teddington Memorial Hospital,781,883,860,905,735,440,260,4864
Riverside Supermarket,700,556,410,786,716,881,789,4838
Ham Food Centre,550,721,740,673,766,839,536,4825
The Co-operative Food,702,796,664,970,790,499,324,4745
Premier B M store,802,779,729,820,671,566,367,4734
Screwfix,632,697,808,726,712,754,369,4698
Carluccio's,624,640,567,582,611,889,758,4671
Toolstation New Malden,701,818,734,785,599,685,346,4668
Co-op Food - Petrol Roehampton Vale,732,707,778,832,876,460,265,4650
Co-op Roehampton Vale,732,707,778,832,876,460,265,4650
Korea Foods,671,667,682,656,697,764,511,4648
David Lloyd Kingston,719,775,674,665,600,633,573,4639
Roehampton Supermarket,658,773,613,600,711,688,587,4630
Better Price,627,695,543,593,539,830,763,4590
Waitrose & Partners Raynes Park,652,677,666,715,712,689,451,4562
Jana Food Centre,646,547,523,645,513,861,792,4527
Waitrose & Partners Twickenham,629,612,611,650,728,807,485,4522
Better Gym Teddington,739,733,769,724,591,426,470,4452
Asda Kingston on Thames Supermarket,662,630,644,658,685,719,450,4448
Vet4Life - Teddington,727,835,425,708,840,543,370,4448
Eurowash Centre,527,679,503,537,511,896,784,4437
Ivybridge Retail Park,704,731,695,669,726,910,0,4435
Cote - Richmond,445,499,524,609,623,991,738,4429
Cote - Kingston,581,444,503,503,694,896,799,4420
Betfred,440,520,735,934,777,424,587,4417
CaffÃ¨ Nero,561,592,655,597,539,829,609,4382
Nisa Local,449,408,677,714,556,656,919,4379
ESSO MFG ROBIN HOOD NORTH,641,710,694,738,679,528,367,4357
Tesco Express,610,649,700,723,647,653,370,4352
Londis,698,579,598,794,689,635,356,4349
Cannon Hill Common,587,486,661,577,552,728,755,4346
Teddington Dental,881,731,879,895,690,206,59,4341
Headmasters Wimbledon Village,594,437,647,759,670,661,572,4340
Mini-market,522,501,792,653,553,672,634,4327
Everydays,596,716,610,666,783,516,436,4323
Co-op Food - Roehampton - Danebury Avenue (Temp),544,581,636,669,593,589,711,4323
Euro Wines Premier,772,509,804,687,783,430,337,4322
Rajah's News,657,493,811,893,733,381,339,4307
Tudor News,355,489,689,708,534,829,688,4292
Sainsbury's,634,581,625,639,623,763,424,4289
Pizza Express,464,456,478,561,816,836,678,4289
Tennis court,944,595,621,525,719,236,648,4288
Roehampton Vaccination Centre,612,670,506,577,754,649,505,4273
Coombe Express,602,933,726,576,455,493,488,4273
King's Head Roehampton,584,364,598,630,660,640,787,4263
Goddard Veterinary Group Stone Lion Veterinary Hospital,598,723,963,515,646,360,422,4227
Coombe Food & Wine,617,553,630,608,730,524,563,4225
Londis,663,629,646,628,611,662,367,4206
William Hill,774,748,504,495,513,549,621,4204
Favorite Chicken & Ribs Kingston,326,448,337,496,933,692,970,4202
Co-op Food - Raynes Park,604,579,590,577,608,557,686,4201
"Shaef Gate, Bushy Park",510,451,507,547,598,743,833,4189
Kingston Maternity Unit,736,750,713,659,682,394,249,4183
Farm Fresh Burgers & Shakes,360,463,701,706,540,791,612,4173
The Kebab Guyz,634,713,687,674,652,427,359,4146
The Kebab Guyz,634,713,687,674,652,427,359,4146
Twickenham Upholstery,717,722,680,795,569,660,0,4143
Toolstation Kingston upon Thames St Georges,648,605,687,717,674,552,232,4115
National Tyres and Autocare,762,763,765,716,305,598,199,4108
Currie Motors Toyota Twickenham,738,749,739,768,687,331,81,4093
Bill's Kingston Restaurant,424,374,429,454,560,1025,819,4085
Hellix Ltd,772,872,581,780,459,360,260,4084
Hawks Road Post Office,741,611,629,681,611,466,328,4067
Household Reuse and Recycling Centre,703,659,647,633,604,499,315,4060
Costcutter,608,681,745,859,339,623,205,4060
Domino's Pizza - London - Twickenham,666,353,539,446,803,616,637,4060
Park,503,490,515,542,498,768,738,4054
The Beech House,372,344,456,501,836,881,661,4051
KFC Hampton Hill,473,526,587,582,669,625,580,4042
Weldfinn,473,477,602,575,436,821,638,4022
"Euro Car Parts, Kingston",651,760,798,768,603,437,0,4017
Ha Ru,694,572,690,636,631,789,0,4012
Fulwell Food and Wine,503,671,518,682,719,503,406,4002
Starbucks Coffee,520,562,569,580,619,581,565,3996
Wickes,649,659,729,627,429,589,305,3987
Gardenia of London,779,860,443,319,424,630,524,3979
Palace Local,915,698,635,554,420,431,321,3974
Kwik Fit - Kingston Upon Thames,464,569,555,726,640,729,289,3972
Alcombe Veterinary Surgery,704,708,817,809,658,261,0,3957
Cote - Teddington,274,518,439,420,612,842,845,3950
Old London Road Tattoos and Piercing,385,515,645,609,548,663,585,3950
HachÃ© Riverside Social,504,377,405,455,624,864,721,3950
Royal Wimbledon Golf Club,442,442,659,702,587,621,494,3947
MERKUR Cashino (Slots) New Malden,498,565,442,406,590,631,799,3931
Machine Mart Twickenham,516,615,593,627,612,622,343,3928
Citygate SEAT Twickenham,765,464,625,578,674,403,413,3922
GRAYS TYRES & SERVICING TWICKENHAM,693,572,687,570,582,569,245,3918
Red Pepper Pizza,509,603,607,333,577,563,724,3916
The Dapper Fox Barbers,333,428,572,792,811,583,394,3913
Majestic Wine,274,384,536,804,737,747,431,3913
Kingston Area Cars,0,558,920,806,672,758,174,3888
Sufi's Kingston,517,551,534,586,589,604,493,3874
Edmundson Electrical,745,849,814,702,723,28,0,3861
CHATKA FRANKA Polski Sklep,524,526,654,660,639,518,340,3861
Simply Fresh,613,636,663,601,610,356,379,3858
The Albert,295,338,495,593,749,725,651,3846
D & M Tools,693,683,637,660,523,647,0,3843
Halfords Autocentre Teddington,755,472,850,722,579,464,0,3842
Westside Tennis Club,646,514,551,554,311,799,466,3841
Marks and Spencer,513,531,541,555,528,740,430,3838
The Little Gym Hampton & Teddington,576,612,347,661,613,544,466,3819
wilko,558,524,523,522,501,732,457,3817
Deluxe Pizza,468,522,490,458,555,646,670,3809
Nando's Richmond,520,384,421,438,555,757,734,3809
Love & Dye: Organic Hair Salon & Nail Bar,279,514,718,842,647,639,168,3807
Tapas Brindisa Richmond,416,323,480,500,614,899,571,3803
The Crown,358,370,390,479,641,835,729,3802
Mill Road Staines Road,472,465,498,502,535,845,483,3800
Protocol Education Kingston,867,716,794,777,643,0,0,3797
Maki & Bowl,489,654,633,541,486,557,429,3789
Boots,664,652,514,575,414,557,408,3784
Wimbledon Common Golf Club,553,694,561,666,583,717,0,3774
Medivet Roehampton â€“ Roehampton Veterinary Clinic,834,796,711,801,630,0,0,3772
Going Swimmingly London,343,366,478,461,438,987,693,3766
Apostles Barber Shop,448,524,696,538,509,691,358,3764
Haria Pharmacy - Part of Pearl Chemist Group,630,681,680,626,588,552,0,3757
Cake & Bingsoo Cafe,511,408,517,457,429,775,656,3753
Tudor Lodge Health Centre,653,697,807,824,703,68,0,3752
Momtaz Shisha Cafe & Rest,614,413,526,551,476,524,648,3752
APPI Physiotherapy and Pilates Wimbledon,819,740,721,743,619,105,0,3747
Foodland,659,677,565,507,538,586,214,3746
Fiesta Party Store,638,632,630,615,601,626,0,3742
Selco Builders Warehouse,669,649,735,688,584,309,100,3734
Dong Phuong,526,360,355,405,467,836,779,3728
"Royal Tennis Court, Hampton Court",332,512,372,684,352,832,640,3724
Bhuti,333,241,644,675,536,752,539,3720
Merityre Specialists Kingston,531,624,677,726,604,554,0,3716
Tibbets Corner (Admiral) Snackbar,629,652,659,649,741,384,0,3714
Paprika Store Twickenham,359,526,532,584,547,747,417,3712
Superdrug,587,511,677,480,551,603,302,3711
Aces barber,501,643,580,674,630,495,187,3710
Cote - Wimbledon,373,456,377,394,569,803,734,3706
Furniture Village New Malden,576,500,584,511,378,714,437,3700
Playing Field,622,480,745,706,333,385,419,3690
Anytime Fitness,561,751,565,665,397,343,405,3687
Twickenham Barbers & Ladies Hair Studio,358,434,570,543,643,741,397,3686
Curzon Richmond,357,425,471,518,495,827,582,3675
Lime & Thyme,257,321,483,562,654,848,550,3675
wagamama kingston upon thames,387,384,367,465,598,796,662,3659
Johnstone's Decorating Centre,711,649,652,691,582,371,0,3656
Alric Avenue Allotments,597,505,408,571,501,557,516,3655
The Rising Sun,333,369,436,467,638,840,562,3645
Just The Ticket,648,784,641,666,624,269,0,3632
Lexus Twickenham,639,692,669,697,555,227,147,3626
Cafe Joy,491,704,503,551,519,412,438,3618
Whitton Luxmy Food & Wine,510,507,439,692,620,476,373,3617
Bubbles Launderette,451,745,425,431,561,512,492,3617
Richmond Greens,352,476,356,392,492,664,876,3608
The Albion,186,402,417,484,709,773,635,3606
LloydsPharmacy,743,753,477,643,719,271,0,3606
Priyas,478,604,639,659,533,441,244,3598
Hampton Wick Surgery,764,688,829,519,792,0,0,3592
SPAR - Kingston Upon Thames,494,544,467,541,542,595,405,3588
The Mute Swan,270,296,317,393,640,916,749,3581
Partica Kingston,491,504,509,390,597,683,402,3576
Snappy Snaps,480,670,548,604,434,504,334,3574
Autoquick,393,687,744,622,596,528,0,3570
Eurotiles and Bathrooms,834,456,658,455,430,487,248,3568
Kwik Fit - Twickenham,554,526,643,543,498,530,272,3566
Gourmet Burger Kitchen (GBK),353,377,291,421,536,840,740,3558
Majestic Wine,431,373,528,515,713,623,372,3555
Nando's Kingston upon Thames,334,411,414,405,507,801,673,3545
Ryan Jayberg Ltd,624,765,680,854,619,0,0,3542
Gemini Electrical Supplies,712,730,646,731,594,123,0,3536
Mojo,547,460,428,732,483,465,415,3530
Poundland,653,559,520,309,467,614,407,3529
Prosperity Ukrainian Cafe & Restaurant,0,281,404,480,598,773,989,3525
MKG3000 Mazda,578,586,657,679,540,380,98,3518
The King's Head,320,315,356,470,598,815,642,3516
Richmond Hill Bakery,407,399,453,433,462,707,650,3511
Nando's Teddington,336,337,471,452,511,754,649,3510
Goddard Veterinary Group Raynes Park,471,851,550,679,722,215,0,3488
Chartfield Surgery,749,645,816,729,547,0,0,3486
Hansel & Pretzel German Delicatessen,0,573,560,552,508,706,584,3483
Bill's Richmond Restaurant,321,322,305,333,447,1004,747,3479
Hard Luck Tattoo,559,464,512,480,507,486,470,3478
Hand in Hand,329,297,404,405,533,768,726,3462
Brewers Decorator Centres,613,738,662,744,459,242,0,3458
I D S L,689,756,737,647,625,0,0,3454
Sajna,0,681,679,662,415,723,288,3448
JCF Car Clinic,776,659,753,643,615,0,0,3446
Ashburnham Road Post Office,710,590,542,584,477,284,257,3444
Mezzet Restaurant,404,379,351,491,537,612,667,3441
Browns Kingston,267,281,305,365,538,984,699,3439
The Masons Arms,287,388,493,383,708,783,393,3435
Specsavers Opticians and Audiologists - New Malden,569,349,455,506,581,607,364,3431
Vape Shack,575,552,336,651,546,590,179,3429
Boots,492,480,486,553,454,649,310,3424
Chamberlains Garage Ltd,599,681,735,782,615,0,0,3412
The Tanning Shop Kingston,546,493,504,432,621,438,366,3400
"Lawsons New Malden - Timber, Building & Fencing Supplies",572,684,657,727,581,177,0,3398
Triangle Dental Clinic,698,718,640,711,556,66,0,3389
Herbert & Shrive - Travel Clinic Teddington,616,730,457,586,598,381,0,3368
Jacksons Ford,576,653,796,619,479,236,0,3359
Jacksons Ford,576,653,796,619,479,236,0,3359
Woven & Woods,593,583,438,609,607,297,227,3354
Primark,444,409,435,485,427,703,448,3351
A J Gas & Water Ltd,542,84,479,422,323,647,854,3351
Alsford Timber,582,640,699,688,514,223,0,3346
Cullifords,616,726,658,715,631,0,0,3346
Mr Clutch Autocentres,733,477,576,540,513,507,0,3346
Grand Drive Surgery,664,704,710,709,559,0,0,3346
Timpson,600,629,0,701,562,600,253,3345
Seoul Plaza,393,410,453,396,419,617,649,3337
The Ram,229,227,350,443,682,939,464,3334
Raynes Park Tavern,240,318,362,463,581,822,537,3323
Hawks Pharmacy,649,608,680,663,606,111,0,3317
Matalan,483,436,452,464,435,603,444,3317
Medivet Twickenham,457,670,697,667,619,193,0,3303
Franco Manca,269,281,356,324,528,841,700,3299
Wimbledon Village Surgery,663,721,762,648,500,0,0,3294
Atariya Foods Kingston,0,560,642,522,571,589,404,3288
Gail's,350,362,338,366,451,705,716,3288
Next,428,420,455,451,417,637,471,3279
Brook House,718,657,704,733,463,0,0,3275
The News Box,502,523,511,459,530,559,189,3273
H Mart,398,395,380,436,472,774,416,3271
Hairline New Malden,245,590,450,750,620,615,0,3270
Cambridge M O T Centre,492,571,532,536,540,599,0,3270
Local Express Wimbledon Chase,0,513,594,523,639,495,504,3268
The Black Horse,276,362,375,428,626,625,571,3263
Volvo at MKG 3000 (Aftersales),623,633,653,617,620,113,0,3259
Conference Badges Ltd,618,660,651,692,638,0,0,3259
Chase Barbers,434,375,344,493,696,691,225,3258
Londis,684,328,430,588,587,361,274,3252
Rushmere,232,279,376,596,684,590,495,3252
Charles Harry Pharmacy,613,330,549,644,661,453,0,3250
Twickenham Veterinary Surgery,586,532,738,637,747,0,0,3240
Lloyds Bank,591,586,614,518,530,399,0,3238
Analogic Computers (Apple Independent Repair Provider),672,747,491,660,665,0,0,3235
Citygate Volkswagen Twickenham Service,656,640,620,548,571,198,0,3233
Park Road Dental Centre,818,804,426,651,306,228,0,3233
Clarence Lane (Stop S),358,282,722,511,411,437,507,3228
Twickenham Post Office,634,624,616,583,506,259,0,3222
Hawkers Bar and Brasserie,396,359,344,297,528,661,632,3217
Kingston Tyre Services Ltd,528,620,624,500,492,444,0,3208
Richmond Road Post Office,613,573,616,593,453,357,0,3205
Mada Deli,0,374,488,457,493,662,729,3203
Bramble & Moss,405,538,281,469,607,615,286,3201
Fatboys Cafe & Restaurant,429,459,478,441,533,406,455,3201
KEYSTONE INDEPENDENT,623,738,643,700,497,0,0,3201
Smokings kitchen,112,407,442,525,694,567,454,3201
Patisserie Valerie - Kingston,412,464,448,652,468,472,284,3200
Greggs,447,481,563,488,572,415,233,3199
Seaforth Store,287,524,505,519,408,480,475,3198
BlueWater Mobile Car Detailing And Carwash,464,433,348,471,366,604,511,3197
Three,576,447,356,553,454,397,412,3195
Blitz CrossFit,610,538,595,428,560,236,222,3189
Carp & Trout,499,297,559,455,538,444,396,3188
The Bishop,279,230,273,390,512,943,556,3183
Buvans Stores (Food & Wines),422,606,477,421,418,323,516,3183
Beehive Boutique Hampton Court,491,544,509,635,564,437,0,3180
Wolseley Plumb & Parts,493,605,691,709,597,85,0,3180
"Autoshine Car Detailing, Car Valeting & ECU Remapping",405,604,671,613,657,228,0,3178
Lovelee Hair,608,424,428,480,548,688,0,3176
Chertsey Road (Stop K),418,621,538,586,507,241,262,3173
Kami's Barber Shop,425,405,440,330,535,595,435,3165
Domino's Pizza - London - Kingston-Upon-Thames,461,431,357,324,609,622,352,3156
Ruba Restaurant,331,313,442,360,600,749,361,3156
The French Correction Garage,584,669,663,706,532,0,0,3154
Cafe Zizou,429,295,473,320,475,604,556,3152
C R S Electrical Supplies Ltd,538,714,569,754,577,0,0,3152
Danny's Hairdressing,224,604,635,471,625,588,0,3147
Mayfield Surgery,572,716,645,581,593,40,0,3147
Fabric Land,403,414,404,421,419,701,383,3145
David Clulow Opticians,597,647,568,634,368,328,0,3142
Teddington Tyres Ltd,424,543,636,588,494,386,67,3138
Live Group - Your Virtual Event Experts.,534,651,666,893,346,21,25,3136
RBR,730,733,715,567,391,0,0,3136
Halfords Autocentre Kingston Upon Thames,428,559,601,718,531,293,0,3130
B&Q Roehampton (Located in Asda),452,373,397,418,463,594,429,3126
K-Town BBQ,375,341,304,301,386,728,689,3124
The Vet in St Margarets,434,737,672,435,677,167,0,3122
The Wych Elm,281,233,403,451,649,591,509,3117
Maple Leaf Pharmacy,515,516,502,469,584,311,218,3115
Gameplan Physiotherapy,696,659,348,865,278,262,0,3108
Alloway Timber,540,670,734,608,486,68,0,3106
Five At The Bridge,411,312,468,378,355,589,591,3104
TONI&GUY Teddington,136,531,686,646,465,636,0,3100
Roehampton -The Danebury Avenue Surgery,605,657,610,608,620,0,0,3100
Pets at Home New Malden,451,432,367,442,395,544,468,3099
MansMatters,487,711,448,629,453,369,0,3097
The Fallow Deer Cafe,208,440,429,469,486,565,498,3095
Costa Coffee,503,371,545,387,370,388,529,3093
Grover Food & Wine,630,0,630,570,820,440,0,3090
Teddington Post Office,617,565,557,522,493,335,0,3089
Charcoal Grill,424,507,407,531,426,434,357,3086
Roehampton High Street 35 Post Office,584,674,595,565,494,174,0,3086
The Canbury Arms Kingston,271,270,318,440,511,646,625,3081
The Vineyard Surgery,743,641,625,547,517,0,0,3073
The Sussex Arms,219,211,316,346,595,836,544,3067
Mint Hairdressing and Beauty,0,704,697,551,455,658,0,3065
The Prince Of Wales,262,242,284,346,515,806,606,3061
Augustus Road Dental Practice (ARDP),578,650,665,545,623,0,0,3061
Professional Plumbing Supplies Ltd,518,620,607,713,603,0,0,3061
Cafe Verde Teddington,452,502,549,330,420,360,447,3060
Kingston Road Post Office,612,630,355,414,416,302,327,3056
The Fox & Duck,333,345,418,271,648,538,502,3055
Subway,385,535,675,695,485,280,0,3055
Lucy White Dry Cleaners,634,438,478,483,622,399,0,3054
Medivet Teddington,666,711,673,548,449,0,0,3047
St Margarets Surgery,688,472,739,601,546,0,0,3046
Park Tavern Pub,360,276,282,345,553,794,434,3044
Cancer Centre London,576,694,654,628,488,0,0,3040
CCL Parkside,576,694,654,628,488,0,0,3040
Emin Read Solicitors,576,637,623,646,557,0,0,3039
RV Tass,576,559,615,612,519,156,0,3037
East Chemist,411,522,582,578,580,364,0,3037
Heavenly Dish,492,589,549,511,665,230,0,3036
Ashburton Medipharmacy,608,570,662,594,496,105,0,3035
Ashburton Medipharmacy,608,570,662,594,496,105,0,3035
Tide End Cottage,228,244,303,400,534,680,641,3030
basketball court,389,351,468,518,255,663,384,3028
Raynes Park Motors,593,667,513,473,478,303,0,3027
ESHO Clinic,412,664,610,506,525,308,0,3025
Radiance Clinic,378,702,487,549,432,477,0,3025
Starbucks Coffee,368,381,469,429,364,617,395,3023
Boots Opticians,475,813,506,375,353,501,0,3023
The Alton Practice GP Surgery - Roehampton,479,736,578,663,499,67,0,3022
The Ivy Clinic,503,690,403,439,601,385,0,3021
Tudor Drive Post Office,568,543,545,600,574,191,0,3021
Tacklebag,678,628,585,554,574,0,0,3019
NEVILLE BARBERS,553,360,397,397,460,403,446,3016
Park Road Surgery,639,621,784,377,594,0,0,3015
Allied Resource Recruitment Limited,515,550,565,645,490,250,0,3015
Medivet Kingston,526,677,666,595,512,36,0,3012
BRUNCH CAFE,398,413,577,594,565,464,0,3011
Best Biltong Kingston,348,510,442,405,410,636,257,3008
Nuad Thai Massage,338,548,511,284,148,471,708,3008
Raynes Park Library,618,459,0,687,637,606,0,3007
GAME Kingston,298,342,456,430,434,676,364,3000
K & P Motors PVT Ltd.,498,617,617,620,494,153,0,2999
Poor Boys,234,355,463,470,614,633,230,2999
CEF,503,570,727,659,443,94,0,2996
Kingston-upon-Thames Crown Court,716,633,592,594,460,0,0,2995
Printstore,630,575,716,648,424,0,0,2993
In Harmony Spirit and Balance,300,500,565,626,464,535,0,2990
Databac,567,587,577,592,667,0,0,2990
Nakedhealth,690,381,565,399,651,281,18,2985
Peacocks New Malden,721,281,415,419,533,615,0,2984
Hampton Wick Garage & Mot Test Centre,438,502,563,614,416,421,28,2982
Sleek Events,612,543,536,734,556,0,0,2981
Costa,377,368,374,389,375,586,505,2974
Piazza Firenze - Hampton,305,312,343,460,482,543,523,2968
Unity Autofactors Ltd,473,495,553,696,555,195,0,2967
Favorite Chicken & Ribs - Roehampton,377,358,449,426,532,482,337,2961
The Teddington Butcher Ltd,0,487,578,615,636,640,0,2956
Noble Green Wines,0,639,581,689,430,489,128,2956
Londark,585,750,555,630,435,0,0,2955
YESSS Electrical Kingston,430,600,645,610,670,0,0,2955
Lizzie's cafe,464,427,550,527,477,393,117,2955
Perfect Smile Dental,643,630,780,740,160,0,0,2953
Lambton Road Medical Practice,570,626,559,631,478,87,0,2951
C For Cakes,663,560,644,455,626,0,0,2948
Danebury Avenue Post Office,574,563,494,572,578,167,0,2948
The Royal Oak New Malden,340,298,286,359,613,499,553,2948
Henry's Kitchen,300,236,220,248,472,810,662,2948
Stylelounge Teddington,0,578,472,600,662,636,0,2948
TK Maxx,353,331,355,391,361,701,452,2944
Sally Beauty,437,415,482,283,314,642,370,2943
Bernis Cutz,0,602,475,673,568,624,0,2942
Physiocentric,411,792,548,414,776,0,0,2941
139 Coffee,403,397,393,452,399,525,371,2940
Post Office,583,639,573,470,512,162,0,2939
AJ Sports Kingston | Fordham,487,574,393,382,463,393,247,2939
Richmond Cafe Thai Kitchen,0,197,490,473,495,787,496,2938
Domino's Pizza - London - Teddington,150,201,479,430,607,755,314,2936
DISH,408,276,370,347,291,594,649,2935
Hampton Hill Sub Post Office,599,621,440,594,439,242,0,2935
Kingston Orthodontics,567,633,634,677,421,0,0,2932
Kew Lighting & Electrical,519,572,610,580,526,119,0,2926
Coombe Hill Pharmacy - Alphega Pharmacy,430,453,514,589,597,342,0,2925
Millimetre Salons - New Malden,0,700,475,475,630,640,0,2920
Hardings News & Grocery Fruit Veg Fresh Fish Frozen Food,417,571,448,263,357,310,554,2920
Pizza Go Go,314,294,390,376,435,565,544,2918
Esquires Coffee,346,300,343,425,330,624,546,2914
Collards,547,656,692,318,700,0,0,2913
IQ in IT Ltd,470,712,667,615,448,0,0,2912
We Buy Any Car Twickenham,374,431,574,400,410,442,275,2906
The Bathroom Showroom,394,473,535,648,474,381,0,2905
Ridgway Dental,453,557,562,662,455,216,0,2905
Aesthetika Dental Studio,570,630,350,550,505,295,0,2900
Wags In Style - Dog Grooming Salon,690,618,0,707,483,401,0,2899
The Roebuck,374,319,280,419,670,580,256,2898
Little Waitrose At Shell Kingstonian,314,310,338,604,333,626,369,2894
Park Road Chippy,437,331,441,378,560,365,382,2894
L'Amandine Patisserie and Coffee House,314,349,377,460,524,418,447,2889
Mayday Motors,558,574,555,609,592,0,0,2888
Best One Express Kingston,421,215,264,315,413,650,606,2884
Ham Cafe,403,501,541,434,464,406,132,2881
Trade Systems,588,617,596,594,483,0,0,2878
St Margarets Medical Practice,547,668,603,593,464,0,0,2875
Lapiazza,249,284,286,221,557,693,581,2871
City Plumbing,604,658,517,573,430,88,0,2870
Fire Stables,197,225,220,322,451,703,749,2867
The Foresters Arms,211,193,232,384,626,601,614,2861
Baron Grey,537,614,702,670,338,0,0,2861
Sunshine & Ravioli,449,341,466,537,518,549,0,2860
Heanens,449,576,470,433,525,403,0,2856
Montfort News,354,0,481,420,490,356,755,2856
Aura Pharmacy,483,476,596,628,473,195,0,2851
St Margarets Dental,521,743,517,624,362,82,0,2849
Claremont Dental Practice,662,337,620,559,506,157,0,2841
The Roehampton Surgery,731,635,644,483,343,0,0,2836
Strawberry Hill Post Office,604,546,430,464,492,246,53,2835
Silvani's Barbers,294,211,438,316,510,833,233,2835
PTS (Plumbing Trade Supplies),438,474,611,636,547,127,0,2833
Teddington Osteopaths,358,549,467,478,525,456,0,2833
St Mary's University Park,416,556,594,720,391,156,0,2833
Southey Bowling Club,377,226,359,316,348,715,491,2832
Mercury Motors Ltd,575,581,521,587,494,73,0,2831
Pizza Express,308,313,365,312,347,701,481,2827
Tops Pizza,296,271,263,493,647,440,417,2827
Elm Road Playground,336,256,242,307,320,702,659,2822
Palace Barber,0,304,434,533,517,691,340,2819
Kingston Hill Post Office,573,572,588,551,431,104,0,2819
Boho Cafe,297,440,405,537,405,510,224,2818
New Generation Cars,456,407,655,466,486,348,0,2818
Alpha Veterinary Surgery,697,677,257,628,427,131,0,2817
HSBC,597,518,486,492,541,182,0,2816
Headmasters New Malden,665,243,489,446,414,559,0,2816
Dara Cafe & Bistro,328,295,249,361,439,679,464,2815
Dental Rooms Wimbledon,421,426,448,588,520,410,0,2813
"Noura Lebanese Restaurant, Kingston",294,291,362,257,484,615,508,2811
"The Prince Albert, Twickenham",202,222,301,375,571,814,320,2805
Roebuck,220,249,289,321,386,679,661,2805
The Prince Albert Twickenham (Stop GB),202,222,301,375,571,814,320,2805
Color 1,424,526,502,560,406,385,0,2803
Clarendon Home Care,633,491,535,611,527,0,0,2797
Papa Johns Pizza,220,354,483,405,535,545,254,2796
Fireaway Pizza Wimbledon,152,142,224,354,588,612,724,2796
Hays New Malden,522,675,642,621,335,0,0,2795
Travel Industry Services,786,713,551,385,358,0,0,2793
Local Hero,311,290,272,297,385,634,604,2793
Sheen Lawn Tennis & Squash Club,496,379,300,550,423,341,299,2788
Specialist Massage Therapies,581,564,640,573,368,59,0,2785
West Wimbledon Physiotherapy Clinic,581,564,640,573,368,59,0,2785
Beverley Dental,479,555,612,678,460,0,0,2784
Dux Global Services Ltd,551,558,516,579,580,0,0,2784
Pharmacare Pharmacy,456,487,638,583,435,181,0,2780
Londis,308,608,468,463,366,427,138,2778
Neom Organics London,351,313,374,545,323,393,475,2774
"The Anglers, Teddington",197,232,232,259,458,769,626,2773
Wimbledon Village Stables,0,450,562,535,515,356,355,2773
Twickenham Cafe,432,474,434,488,527,417,0,2772
Kingston Vale Post Office,469,492,480,438,327,348,216,2770
EE,350,305,567,466,399,541,142,2770
Decowall,589,587,536,542,515,0,0,2769
Sweety News,489,461,489,460,394,369,107,2769
Istanblu,288,265,244,288,353,698,633,2769
The Place,313,326,312,300,338,598,575,2762
LK Bennett - Bentalls,328,316,319,390,383,643,382,2761
The Red Lion,115,145,272,436,653,702,438,2761
Dental Care Centre,518,568,530,594,548,0,0,2758
Wolseley Plumb & Parts,522,561,594,588,400,92,0,2757
The Coffee Mill,331,344,329,377,312,523,541,2757
Sirishas Health & Beauty Spa,0,545,559,567,563,521,0,2755
Holly & Co,396,469,416,491,416,248,315,2751
JNDC Ltd,501,601,610,561,478,0,0,2751
The Teddington Arms,109,175,418,346,516,773,410,2747
Chameleon,138,293,596,193,581,752,192,2745
Perfect Smile Dental,694,511,838,177,469,54,0,2743
The Village Cafe,443,437,429,415,507,512,0,2743
Bluebird Care Richmond & Twickenham,465,578,613,587,499,0,0,2742
Zizzi,256,217,223,279,497,618,650,2740
Creams Cafe Kingston,277,380,308,441,439,448,446,2739
Visual Impact,474,585,581,675,422,0,0,2737
The Grey Horse - SMOK'D,221,226,378,364,510,637,400,2736
Aspria,670,345,579,749,388,0,0,2731
Alexanders Of Twickenham Ltd,552,655,336,653,533,0,0,2729
Raynes Park High School Sport Hall,302,394,386,421,185,523,515,2726
Genova Diagnostics,519,618,541,580,461,0,0,2719
The Vet on Richmond Hill,733,389,418,548,510,119,0,2717
Ray Cuts,389,330,464,311,322,623,278,2717
Howell Jones Solicitors,480,554,493,533,655,0,0,2715
The Pottery Tapas Bar,71,211,295,361,534,823,420,2715
Rowleys,494,448,418,474,558,321,0,2713
Wimbledon Dental Practice,677,625,571,408,385,45,0,2711
The Adelaide,146,233,301,521,591,559,359,2710
The Railway,130,231,239,418,507,491,693,2709
Laurel Pharmacy,515,521,482,445,537,206,0,2706
Victoria Pub Richmond,162,205,330,353,456,696,501,2703
Caesar's Camp,458,0,320,677,394,489,364,2702
Bevan's Butchers,301,361,230,405,386,621,395,2699
Hampton Hill Library,548,0,659,560,489,442,0,2698
Gents Barbers,300,448,364,508,489,589,0,2698
144 On The Hill Restaurant and Bar,282,225,265,226,406,734,558,2696
Trio Systems,612,542,601,453,484,0,0,2692
"The Naylor Library, St Mary's University, Twickenham",576,800,375,610,230,99,0,2690
Sports Direct,274,347,340,404,324,572,429,2690
Strawberry Hill Cafe,428,480,457,504,454,366,0,2689
The Cookaway,471,697,477,552,490,0,0,2687
Reed Recruitment Agency,396,751,445,816,278,0,0,2686
GP Motors (Teddington) Ltd,497,524,601,542,522,0,0,2686
Headcase Barbers,0,440,621,539,656,430,0,2686
The Cherrytree Dental Care - transform your smile with our digital technology,458,743,590,244,487,162,0,2684
Las Iguanas - Kingston,243,231,257,308,518,705,419,2681
Ricky's Hair Salon,457,246,310,493,421,664,89,2680
The Olive,276,135,279,330,367,591,701,2679
The Terrace Eatery,249,347,309,361,333,572,507,2678
Enterprise Car & Van Hire - Kingston,560,516,461,539,448,151,0,2675
WSM Marks Bloom LLP,547,560,620,380,565,0,0,2672
Bradbury Stell,406,692,446,700,421,0,0,2665
MATCHESFASHION,516,480,360,532,501,270,0,2659
Brightsmile Kingston,602,404,616,614,184,237,0,2657
Mandolin/Guitar Build & Repair (Shady Rigs Luthier),410,387,682,471,364,342,0,2656
Wags N Tales,150,293,194,239,389,867,516,2648
Europcar London Kingston Upon Thames,637,336,486,537,429,207,15,2647
C B S (Whitton) Ltd,0,496,659,539,501,450,0,2645
River Island,300,298,288,442,360,584,371,2643
Printing Planet UK - Custom T-shirt Printers in London,449,477,442,494,498,281,0,2641
Groves Pharmacy,479,460,447,538,601,114,0,2639
The Spring Grove,141,131,210,401,543,782,428,2636
Crave Cafe & Shisha Lounge,166,247,312,373,417,446,674,2635
Required IT,566,604,502,546,416,0,0,2634
Waves Hand Car Wash,325,216,229,436,364,502,560,2632
Kingston University Penrhyn Road (Stop S),469,677,395,566,341,127,56,2631
Woody's,32,191,204,325,531,877,470,2630
Scribbler,391,437,239,379,365,580,238,2629
Richmond Road Dental Practice,511,680,474,412,252,299,0,2628
Eden Kebab Kingston,294,269,321,352,351,483,557,2627
Taylor Rose MW Kingston,509,638,492,488,500,0,0,2627
kingstonfeet,671,397,691,245,417,205,0,2626
Nima Chemist and Travel Clinic Richmond,474,493,565,429,512,153,0,2626
The Royal Oak,124,152,413,243,474,800,415,2621
YingWan Thai Therapy - Kingston upon Thames,640,237,159,303,241,453,586,2619
The Groves Dental Centre,489,554,464,546,421,143,0,2617
Quality Grocers Off Licence & Newsagents,433,381,481,337,373,611,0,2616
Radnor Gardens,465,492,560,590,508,0,0,2615
Colicci Roehampton Gate CafÃ©,279,246,215,275,256,653,686,2610
Kingston University County Hall (Stop UH),477,470,501,471,342,201,146,2608
Tide Tables Cafe,292,262,250,304,302,628,566,2604
Orchard Lane,350,258,382,347,406,454,402,2599
Orchard Lane,350,258,382,347,406,454,402,2599
Orchard Lane,350,258,382,347,406,454,402,2599
Brouge Gastropub,169,285,251,254,459,642,538,2598
Goddard Veterinary Group Kingston,626,645,97,510,602,115,0,2595
Wonderlust,115,317,612,569,626,351,0,2590
Kingston Wild Flowers Ltd,457,587,386,476,324,359,0,2589
"Riverside Gym, Hampton Court",264,436,344,544,254,416,326,2584
Cannizaro Park,252,273,231,297,289,560,679,2581
Jai Dee Thai Massage East Molesey,483,622,353,295,364,306,158,2581
CIAR Property Services Ltd,530,355,538,563,592,0,0,2578
National Tyres and Autocare,371,433,413,488,625,236,0,2566
Boho Cafe,483,0,457,354,500,545,227,2566
Damira Cross Deep Dental Practice,358,609,710,415,474,0,0,2566
"SOUL Coffee, Tea and Health food",290,257,315,401,524,437,337,2561
The Lion,113,202,148,246,692,664,494,2559
Headmasters Ham Academy,507,502,534,489,522,0,0,2554
M & D Autos,427,549,469,576,458,75,0,2554
Ham Parade Pharmacy,370,616,470,426,435,236,0,2553
Cafe Pera,234,320,376,293,383,423,523,2552
The Marlborough,124,142,167,244,341,871,663,2552
Piazza Firenze,179,244,238,291,484,661,455,2552
Duke of Buckingham,204,249,280,270,483,644,419,2549
Synergy Clinic,651,659,475,500,263,0,0,2548
Costa Coffee,407,417,539,344,361,125,355,2548
Capelli,0,609,682,250,495,509,0,2545
L'Amandine Patisserie and Coffee House,291,248,324,479,342,377,483,2544
STM Environmental Consultants Ltd,413,543,594,528,462,0,0,2540
Latchmere Recreation Ground,318,294,348,341,270,529,438,2538
Clipper and Cloth,0,285,513,510,530,700,0,2538
EE,356,395,389,296,319,513,264,2532
The Norbiton,171,112,147,323,558,770,450,2531
Sabayjai Thai Therapy,378,534,257,424,203,428,299,2523
JD Sports,302,263,289,387,316,543,420,2520
Shape Hair Design + The Beauty Room,0,270,606,484,503,651,0,2514
Hampton Wick Health,482,756,470,499,307,0,0,2514
Twickenham Dental Care,583,609,670,0,283,368,0,2513
The Maris Practice,475,617,483,615,218,101,0,2509
Serco,431,472,573,550,475,0,0,2501
East Lane (Stop UM),433,517,198,476,413,291,173,2501
Tesco Pharmacy,162,335,502,527,593,380,0,2499
Accord Accountants,499,574,517,513,395,0,0,2498
Agassi Hair,216,334,334,230,604,432,347,2497
Toothbeary - Children's Dentist,440,417,654,613,373,0,0,2497
R S Tool Repairs,458,567,478,535,458,0,0,2496
The Press Room,297,325,358,377,364,461,313,2495
Busaba Kingston Riverside,270,180,212,223,528,620,462,2495
Nationwide Building Society,613,479,429,511,329,130,0,2491
Confident Dental Practice - Dentist Raynes Park,464,388,735,184,472,243,0,2486
Zizzi,183,274,310,299,333,625,461,2485
Percy Chapman & Son Ltd,330,403,480,438,356,478,0,2485
Olive Tree Pizza,330,96,126,268,557,587,518,2482
Trilogy Stores,507,453,297,296,330,597,0,2480
Food For Thought,444,143,384,363,370,539,233,2476
RSPCA Monument Richmond,506,497,438,460,570,0,0,2471
RaceTech,442,518,477,596,438,0,0,2471
Vanessa Nails,489,320,296,579,425,362,0,2471
Adams Mechanic Raynes Park,450,560,450,470,540,0,0,2470
Evolved Clinic,796,276,0,716,292,388,0,2468
Skipton Building Society - Kingston,471,476,435,547,538,0,0,2467
Living Centre Clinic,437,588,414,432,596,0,0,2467
MIMO HAIR,0,444,448,401,485,689,0,2467
Direct Support Ltd,521,668,354,533,385,0,0,2461
Lock Road Surgery,457,461,732,403,406,0,0,2459
icon hairdressing,0,233,411,614,567,633,0,2458
Al Forno Restaurant,216,225,154,201,387,692,582,2457
Coombe Stationers & Printers Ltd,326,403,470,461,417,380,0,2457
Kendall Cars - A3 Branch,443,481,497,434,444,157,0,2456
Reveal Media Ltd. Body Worn Cameras,453,578,739,359,325,0,0,2454
Helenâ€™s Star Nails,357,194,303,408,382,616,194,2454
Coombe Wood Lawn Tennis Club,312,328,348,361,205,532,363,2449
The Richmond Dentist,312,689,853,332,262,0,0,2448
& Other Stories,226,298,243,292,337,635,413,2444
Stein's Kingston,0,0,250,278,487,875,553,2443
Flight Centre: Head Office,245,598,756,759,84,0,0,2442
Fratelli,278,429,484,322,421,506,0,2440
Cab Stop Taxi Repairs Ltd,608,560,432,384,456,0,0,2440
Therapy4kids,357,595,564,494,428,0,0,2438
Oliver Bonas,370,272,176,281,343,656,338,2436
Strawberry Global Technology,560,592,591,347,344,0,0,2434
Holland & Barrett,424,0,424,627,416,542,0,2433
St Margarets Pharmacy,371,446,512,520,433,151,0,2433
Pizza Express,181,240,276,287,339,649,460,2432
Royal Mail Depot,347,415,434,426,422,345,43,2432
Teddington Health and Social Care Centre,507,580,582,402,356,0,0,2427
Genesis Capital Group,437,457,591,511,430,0,0,2426
Tudor Lodge Dental Practice,332,412,533,655,490,0,0,2422
Health On The Hill,539,412,465,420,334,251,0,2421
The Glasshouse,175,280,229,315,621,538,261,2419
Action Graphics Ltd,504,597,440,460,417,0,0,2418
HSBC,496,545,473,387,516,0,0,2417
KANSET PHARMACY,488,419,633,389,274,213,0,2416
Thai Tho Wimbledon,257,233,276,349,461,467,372,2415
Taste of Cochin,388,338,310,379,296,492,210,2413
Oh My Nails,331,227,385,292,470,411,292,2408
Andy's Salon,282,289,231,407,508,688,0,2405
Autotec Workshop & MOT Testing,431,523,383,643,424,0,0,2404
Sky Electrical Ltd,341,298,827,226,711,0,0,2403
Hampton Hill Medical Centre,428,481,529,408,554,0,0,2400
The Eye Galleria Opticians,552,512,0,740,0,596,0,2400
Charm Thai Dining,0,359,344,264,474,541,413,2395
La Moda Restaurant,235,251,207,288,411,598,405,2395
Buddhapadipa Temple,172,242,317,297,257,557,551,2393
Elphick Clinic,301,619,506,486,480,0,0,2392
Tucker French Surbiton,421,462,514,470,482,42,0,2391
Stationery Shop at St. Margaret's,586,432,310,414,394,255,0,2391
Fika,285,389,382,442,429,462,0,2389
PC Mac Doctors,540,0,0,608,352,536,352,2388
Willoughby Arms,173,327,214,247,346,389,684,2380
Rohan Kingston-Upon-Thames - Outdoor Clothing & Walking Gear,264,256,352,336,388,484,300,2380
One One Four,0,222,204,454,592,611,295,2378
Soni Dental Implants,468,514,559,234,601,0,0,2376
Prymus Car Garage,590,526,291,456,510,0,0,2373
Cura Care Ltd,352,531,582,637,270,0,0,2372
Kobkun Thai Retreat Kingston,219,145,195,336,452,248,772,2367
The Prince of Wales Pub,217,167,162,244,518,607,450,2365
Clarks,289,273,239,319,237,600,407,2364
Samis Barber,376,317,311,336,236,784,0,2360
Lallapolosa Baking Company,488,299,477,311,474,311,0,2360
Manoo & Rita,268,357,271,322,734,406,0,2358
Lloyds Bank,580,495,391,351,539,0,0,2356
Sheena News,231,330,522,516,453,304,0,2356
Latin Routes,374,574,314,665,281,147,0,2355
Physio & More Ltd,421,531,467,543,276,0,113,2351
County Coachworks,375,497,338,752,389,0,0,2351
Waterstones,369,313,277,291,311,505,284,2350
White House Dental Practice,575,496,662,434,179,0,0,2346
Gaya Korean Restaurant,357,0,322,390,360,513,403,2345
La Dolce Vita,185,264,293,285,464,528,322,2341
HSBC Bank Plc,548,406,564,409,410,0,0,2337
Goals Wimbledon,321,422,333,375,359,230,295,2335
H & L Motors,539,578,426,456,331,0,0,2330
Twickenham Charcoal Grill,221,243,355,273,382,480,363,2317
Waterstones,264,251,247,291,257,609,397,2316
Topps Tiles Raynes Park - SUPERSTORE,414,484,0,572,0,547,297,2314
Taylor's Wine Merchant,0,493,414,452,458,494,0,2311
Manuels,391,347,451,345,379,397,0,2310
Teddington Pharmacy,433,404,372,402,484,214,0,2309
Bar Estilo,222,227,253,271,400,605,331,2309
Thameside Medical Practice,527,646,376,266,492,0,0,2307
Johnstone's Decorating Centre,586,443,418,545,314,0,0,2306
Yami Restaurant,166,217,138,252,242,657,631,2303
Family Dental Health Centre,417,486,664,432,303,0,0,2302
Oddbins,0,0,510,391,377,438,584,2300
UNIQLO Kingston,271,259,231,286,213,615,421,2296
Meades Motors,375,368,669,452,432,0,0,2296
St Margarets Tavern,158,121,259,216,272,888,381,2295
The London Prosthetic Centre,461,476,496,429,433,0,0,2295
The Angel Roehampton SW15,237,181,209,340,229,570,526,2292
Carbon Architecture Ltd,592,346,398,522,431,0,0,2289
BOSS Store,203,169,215,254,359,606,482,2288
The Rifleman,151,240,239,334,506,546,272,2288
Hatay Restaurant/Raynes Park/Wimbledon,0,272,284,354,356,525,495,2286
Aquatint,518,570,0,651,544,0,0,2283
Rowheath (London Stitch & Print Ltd),596,674,322,287,404,0,0,2283
O2 Shop Kingston Upon Thames,357,373,350,299,336,566,0,2281
Orchard Clinic,409,555,385,410,521,0,0,2280
Roehampton Library,791,0,843,0,430,214,0,2278
Hampton Court Park (Home Park),0,0,446,441,325,479,586,2277
Caffe Bellissimo,336,286,428,407,379,344,91,2271
"St Mark's Orthodontics, Teddington",103,745,466,663,259,31,0,2267
Joseph's Hair St Margarets,0,281,347,520,328,466,325,2267
Burger Beast,186,259,309,447,391,286,386,2264
Girasole Deli,229,247,306,246,228,551,457,2264
Kapak Turkish Restaurant,0,284,236,295,460,457,531,2263
Business Clan Ltd,600,565,480,425,190,0,0,2260
Pitcher & Piano Richmond,124,101,128,296,388,859,362,2258
LUSH Kingston,255,295,236,281,328,524,338,2257
Cotswold Outdoor Kingston Upon Thames,321,227,232,225,297,580,372,2254
Allan barbers,0,337,0,414,378,706,418,2253
Han Bar Restaurant & Karaoke,180,229,224,202,470,615,329,2249
The Cardinal Peppe Restaurant Kingston,0,100,156,130,417,800,645,2248
The Bloated Mallard,122,225,193,343,484,625,255,2247
Richmond Music Trust,354,534,565,505,287,0,0,2245
Handelsbanken Kingston,345,555,470,445,430,0,0,2245
The North Clinic,822,0,402,403,616,0,0,2243
Sapori TW1,241,202,267,341,424,564,201,2240
Richmond Canoe Club,95,292,251,296,197,673,426,2230
The Eel Pie,101,189,207,304,419,734,275,2229
Ozzie Rizzo - Atelier,0,143,578,217,559,701,21,2219
Baan Thai Massage,0,0,585,743,662,226,0,2216
Lass O'Richmond Hill,178,227,136,226,313,554,581,2215
Root Canal Dental Referral Centre,466,460,470,439,342,38,0,2215
Kings Cafe,337,324,310,465,426,350,0,2212
Superdry,248,208,206,275,228,616,422,2203
Yimchai (Kingston),0,232,277,270,384,622,417,2202
Maple Dental Centre,549,526,533,385,209,0,0,2202
Mezzet Dar Tapas Restaurant,0,265,369,483,540,544,0,2201
KPY Phillips Young LLP,380,576,269,676,298,0,0,2199
Rose & Rose Solicitors,413,618,467,388,313,0,0,2199
Minuteman Press Hampton Hill,352,457,667,406,314,0,0,2196
Raven Roofing Supplies,420,406,538,479,353,0,0,2196
The Abercorn Arms,127,188,201,318,504,495,363,2196
Nightingale Centre (LRC),256,394,475,589,336,63,77,2190
Domino's Pizza,178,239,249,227,477,434,384,2188
Kingston Vets,354,478,492,487,297,77,0,2185
Cambridge Park Convenience Store,290,259,296,254,224,533,324,2180
DestinationSkin Richmond St Margarets,102,273,578,371,403,452,0,2179
Designer Cakes by Elle,207,579,0,418,424,289,260,2177
Motionspot,584,0,274,705,612,0,0,2175
Teddington Hardware,456,267,438,324,346,344,0,2175
Paperchase,211,216,192,355,295,605,300,2174
TW1 Physiotherapy,575,427,372,363,363,72,0,2172
Lbox Communications,369,592,396,384,428,0,0,2169
Claire's,244,209,179,293,236,635,373,2169
Moormead and Bandy Recreation Ground,376,406,454,447,482,0,0,2165
Heal's,315,233,183,222,261,521,426,2161
Welsh Pantry,0,496,624,0,636,404,0,2160
The Cavern,50,137,241,321,495,575,338,2157
Refresh Dental,523,261,319,725,188,140,0,2156
Raw Bistro,137,328,321,355,416,599,0,2156
Divine Dry Cleaners,542,375,435,397,0,407,0,2156
Hampton Court Superstore,311,233,410,270,0,546,379,2149
Adesso Sicilia,0,229,234,250,390,559,484,2146
Terra Mia,309,281,310,343,429,473,0,2145
Hannaford's Bar,411,279,433,505,516,0,0,2144
Panda Garden,226,257,181,273,384,414,407,2142
Firefly Hair,0,381,380,453,451,476,0,2141
Stitch N Fix,0,691,554,510,0,384,0,2139
Surya Hot Yoga,291,251,338,228,158,445,427,2138
Universal Auto Electrics,280,735,780,335,0,0,0,2130
Canbury Community Garden,188,264,216,246,166,521,525,2126
David Howard-Accountancy Outsourcing,0,419,611,709,385,0,0,2124
Gaia Wholefoods,302,216,587,247,461,309,0,2122
Mango,248,231,191,291,251,562,345,2119
Barclays ATM,504,417,456,391,350,0,0,2118
Narenj Restaurant,215,165,135,233,275,653,441,2117
Hampton Hill Pharmacy,232,328,340,360,379,475,0,2114
NakPhotography,221,230,312,420,346,333,248,2110
Richmond Vault Beer Cellar & Restaurant,0,136,203,235,399,732,403,2108
The Fox & Grapes Wimbledon,0,0,198,237,310,650,710,2105
Itabashi Japanese Izakaya,0,301,254,218,498,538,292,2101
Kingston Town End Pier,99,96,1,186,238,795,685,2100
Quartet Capital Partners LLP,446,675,446,520,0,0,0,2087
Tangawizi Restaurant,0,260,267,312,446,468,333,2086
The Green Surgery,406,469,509,405,296,0,0,2085
75 Hair Salon,0,401,389,412,372,510,0,2084
KJ Restaurant,185,340,464,259,365,469,0,2082
Riverside Vegetaria,188,126,158,183,344,648,432,2079
Matheou's Fish Bar and Restaurant,209,219,249,339,600,461,0,2077
Triple 7,0,463,464,344,319,483,0,2073
Hampton Court Gardens,0,0,353,338,284,533,563,2071
Millennium Food & Wine,403,411,0,0,364,422,471,2071
Hampton Court,0,0,353,338,284,533,563,2071
Richmond Rascals,0,455,433,367,285,527,0,2067
Melbourne City,0,369,447,446,431,184,187,2064
Lower Ham Play Garden,183,184,193,163,205,542,593,2063
Mi Vida Hair and Beauty,311,427,411,526,384,0,0,2059
Hollyhock Vegetarian Fairtrade Cafe,229,214,205,199,208,477,526,2058
Waterstones,230,163,226,299,274,458,408,2058
Parsonage & Co,425,392,400,501,339,0,0,2057
Leigh Gallery & Picture Framers,166,402,234,428,358,468,0,2056
Illumin8 Beauty,249,365,310,429,542,154,0,2049
VouchedFor,380,662,285,158,564,0,0,2049
Hiro Hiro,0,444,162,502,480,333,117,2038
The Bistro Cafe,186,256,299,324,234,282,456,2037
Aura Centre of Dental Excellence & Facial Aesthetics,290,328,600,501,316,0,0,2035
Roehampton Dental Care,590,370,429,317,324,0,0,2030
Infidelity,0,472,468,500,317,269,0,2026
RAFT Furniture,303,244,589,325,226,140,197,2024
Cole Court Centre,238,206,395,213,293,671,0,2016
EKA Services Ltd,349,397,395,455,243,175,0,2014
Day & Nite Services,394,415,348,483,371,0,0,2011
Globe Independent Financial Advisors Ltd,500,470,500,0,540,0,0,2010
Bar Malden,91,128,221,247,415,674,225,2001
TG-HAIR,0,242,389,418,493,458,0,2000
Haweli of Teddington,0,229,212,430,425,437,267,2000
The Bricklayers Arms,302,485,546,334,2,9,322,2000
Greggs,277,298,325,396,353,164,184,1997
Osteria Pulcinella,248,147,261,254,364,510,212,1996
Liles Morris Chartered Accountants,661,657,676,0,0,0,0,1994
Ristorante Del Posto,0,238,223,227,366,553,385,1992
Ham Dental Practice,0,711,507,563,210,0,0,1991
The Body Shop,406,169,335,236,239,598,0,1983
Farrow & Ball Richmond Showroom,215,629,499,253,116,137,132,1981
Shuropody Foothealth,260,353,200,383,230,548,0,1974
Robson's Butcher and Deli,0,262,393,263,375,490,185,1968
Angel & Dove,415,553,517,475,0,0,0,1960
Sakura Yakiniku,0,174,186,217,418,467,495,1957
Imperial China,220,189,205,182,292,413,455,1956
Boux Avenue,211,173,201,259,212,535,350,1941
Bootcamp Pilates,305,256,190,586,329,270,0,1936
HAMPTON NEWS & BOOZE,217,301,271,138,193,430,385,1935
CREATE Fertility,372,317,454,361,427,0,0,1931
Patrick Parsons Twickenham,12,544,776,537,61,0,0,1930
Old Town Hall,231,373,482,261,429,154,0,1930
The Riverside Tailors,186,252,262,366,252,520,90,1928
Don Emilio,0,176,339,220,169,457,566,1927
Goddard Veterinary Group Ham,506,511,398,96,205,207,0,1923
Viking River Cruises,175,586,707,325,127,0,0,1920
Fish Bar Twickenham,261,231,215,253,491,469,0,1920
Hungerford Motors Ltd,432,423,362,383,320,0,0,1920
F45 Training Kingston,169,414,333,255,238,287,214,1910
Estee Lauder,317,224,236,262,180,501,187,1907
Wildwood,190,171,165,174,251,621,330,1902
York Pet Supplies,315,385,315,405,240,240,0,1900
Absolutely Recruitment Ltd,0,726,675,498,0,0,0,1899
Airone Aviation Limited,497,661,390,224,121,0,0,1893
Sheer Laser & Skin Clinic,459,297,156,268,263,447,0,1890
INGINE (Michael Popper Associates),507,395,556,0,430,0,0,1888
Happy Potter Ceramics,0,246,227,195,65,535,620,1888
Rock & Fairy,0,421,228,231,343,664,0,1887
Murray Park,219,178,272,226,157,315,514,1881
Deea - Modern Indian Establishment,217,147,195,211,377,438,296,1881
Dr Injy G,284,291,279,0,542,485,0,1881
Al Boccon Di' vino,0,239,164,228,299,615,334,1879
Teddington Constitutional Club,145,189,310,232,458,335,209,1878
Aqua Bathroom,336,467,404,349,310,0,0,1866
Fairhill Medical Practice,347,461,306,299,448,0,0,1861
Perfect Pooch,248,285,357,417,282,271,0,1860
ShakeAway Kingston,194,235,156,240,176,508,349,1858
The Swan,145,97,89,347,377,629,173,1857
"AXM Group Motorcycles, Scooters & Automotive Garage",435,625,385,410,0,0,0,1855
PodPoint Charging Station,55,239,367,111,0,424,657,1853
Lebanon Park Dental Practice,601,177,222,660,191,0,0,1851
Tattoo UK,563,507,0,0,0,450,331,1851
Crown Motorcycles,0,0,584,490,417,358,0,1849
Typo,186,169,178,251,199,546,318,1847
The Vape & Shisha Hub Kingston,258,278,354,411,371,125,48,1845
Swift Tuning,0,373,511,618,342,0,0,1844
Taste of Raj,37,153,247,238,387,455,325,1842
Bubbles Shisha Cafe,226,263,206,248,211,382,301,1837
Essential,256,126,240,242,264,533,174,1835
Joseph Hood Recreation Ground,180,171,226,200,174,555,327,1833
Westmoor Community Health Clinic,279,600,447,364,142,0,0,1832
Hays Kingston,208,537,302,654,126,0,0,1827
Windmill Organics Ltd,229,385,222,670,320,0,0,1826
Tommy Hilfiger,221,149,113,228,192,458,460,1821
Masaniello,0,253,126,271,269,639,260,1818
Ribs & Burgers Teddington,0,118,274,226,487,377,326,1808
Da Mimmo Ltd,268,218,317,261,238,504,0,1806
Forward House Hall,0,73,352,282,70,666,359,1802
Woofs A Daisy,280,0,291,374,440,407,0,1792
Wimbledon Dental Care,362,292,541,333,0,264,0,1792
CaffÃ¨ Nero,206,187,224,161,220,466,324,1788
Jerk Shack,0,343,221,0,557,663,0,1784
Hampton Wick Dental Centre,300,305,340,535,300,0,0,1780
TLC Tattoo & Piercing,0,328,447,428,247,329,0,1779
Obon - Sushi and Udon,0,287,195,226,560,499,0,1767
Chambers Bespoke Tailors ltd,365,271,231,0,313,576,0,1756
GeoFossilsÂ®,356,216,396,214,346,0,227,1755
SKIN Lounge,266,298,243,242,425,275,0,1749
AF Beauty Kingston,250,250,218,290,287,454,0,1749
Fire Systems Ltd,367,439,504,433,0,0,0,1743
Sweaty Betty,237,297,190,138,198,220,463,1743
Ben Forrest your hairdresser,0,607,0,605,0,529,0,1741
The Cheeky Pea,258,255,268,279,274,406,0,1740
Children's playground,108,80,165,130,246,511,497,1737
Arlington Auto Precision,390,520,380,445,0,0,0,1735
Park Lodge,368,355,453,0,554,0,0,1730
Vanilla patisserie,176,174,143,220,230,403,379,1725
The Builders Arms,123,70,56,155,327,670,321,1722
Strawberry Woods Play Area,252,100,219,145,176,375,453,1720
The Chip Club,0,233,303,281,517,386,0,1720
Fairfield Children's Playground,296,0,189,314,232,382,304,1717
Treestone BBQ restaurant,214,0,239,320,292,407,244,1716
Interfacio Ltd,457,497,365,396,0,0,0,1715
Great Fish and Chips,175,262,191,270,466,351,0,1715
Vai's Kitchen,0,314,230,228,406,432,104,1714
Lebanese Express Halal,324,269,160,160,331,460,0,1704
"Moidul's Hampton Wick Tandoori, Kingston upon Thames",0,221,229,380,376,343,153,1702
Richmond Hill Thai Massage (TW10 6QX),0,488,261,229,436,0,283,1697
Crystal Chinese Takeaway,84,124,84,277,363,417,342,1691
Galloway Hughes LLP,0,0,446,533,708,0,0,1687
Whistle Stop,144,146,204,295,439,280,179,1687
Haxton & Co,591,321,490,284,0,0,0,1686
Electric Scooters London,412,320,504,42,405,0,0,1683
Riverside Walk Kingston,296,196,241,229,312,0,409,1683
Lal Akash Restaurant,0,199,217,380,276,389,222,1683
Sblended Milkshakes Kingston,255,264,171,252,0,410,330,1682
MATSUBA,0,181,198,277,499,522,0,1677
Twickenham Food & Wine,190,178,171,252,223,511,152,1677
Shambles restaurant & winebar,0,161,230,255,415,609,0,1670
The Cavan Bakery,339,136,281,285,242,383,0,1666
Siam Paragon,0,124,128,230,419,456,304,1661
Sewells Newsagents,293,530,0,374,0,463,0,1660
Cambrian Centre,467,281,267,266,180,196,0,1657
Three70 Bar & Shisha Lounge,132,269,132,347,296,479,0,1655
Spiral Cellars Ltd,265,370,290,0,725,0,0,1650
The Press Gang,0,404,385,0,319,541,0,1649
Parkhurst Self Drive Hire Ltd,424,624,256,336,0,0,0,1640
Memories,0,396,0,441,325,477,0,1639
The Three Kings,72,133,102,208,276,616,230,1637
The Dysart Petersham,0,0,231,384,427,406,186,1634
Sweaty Betty,254,0,0,244,312,464,355,1629
Twickenham Health Care,244,197,407,387,225,162,0,1622
The Exchange,473,338,367,293,149,0,0,1620
Teddington Cheese,0,122,112,376,437,559,0,1606
Armstrong's Family Butchers,148,191,240,264,281,482,0,1606
TWICKENHAM MARTIAL ARTS COLLEGE,429,332,365,182,0,291,0,1599
Picton Room,646,447,0,504,0,0,0,1597
Watermans Richmond,0,0,113,212,547,527,193,1592
The Good Earth Express,214,139,282,159,397,239,161,1591
Ding Tea,161,160,138,177,190,430,335,1591
Strawberry Hill House & Garden,355,479,462,0,0,0,291,1587
Perfect You,123,466,0,474,522,0,0,1585
Boots Pharmacy,386,295,0,289,327,282,0,1579
Turner's House (Sandycombe Lodge),0,0,360,478,241,497,0,1576
Tudor Drive Pharmacy,260,364,184,192,389,187,0,1576
Chu Chin Chow,141,138,158,165,317,404,248,1571
The Fighting Cocks Bar & Venue,162,139,109,123,305,534,195,1567
Well Roehampton - Danesbury Avenue,0,453,481,459,0,165,0,1558
Twickenham Tandoori,124,160,109,226,343,430,165,1557
Thai Upon Thames,173,126,185,126,341,387,215,1553
Pullingers Art Shop (Kingston),175,152,186,0,178,405,456,1552
Ark Dental Practice,189,544,305,292,221,0,0,1551
Taylor'd Lighting & Interiors,0,306,282,0,216,496,236,1536
Crusader Travel Ltd,331,421,374,406,0,0,0,1532
Stag Lodge 2,0,304,216,0,239,313,458,1530
The Fox - Twickenham,61,44,85,132,340,741,124,1527
COOK Teddington,0,0,154,0,378,666,328,1526
Fresh Fare,0,0,255,275,245,385,365,1525
The Souvlaki,0,0,97,299,318,439,370,1523
Kingfish,213,226,222,214,358,285,0,1518
"The Cocoanut, Kingston",101,196,162,272,422,361,0,1514
Roz Ana,121,109,168,170,360,400,184,1512
Queenâ€™s Promenade,161,223,224,288,195,420,0,1511
"The Cabbage Patch, Twickenham",37,71,103,131,231,825,111,1509
Aurora Metro and Supernova Books,0,450,588,457,0,0,0,1495
Terrace Field,60,106,116,145,159,442,461,1489
Aromaden Dental and Implant Clinic,444,208,280,383,173,0,0,1488
"The Turk's Head, Twickenham",61,130,111,112,243,685,146,1488
The Fountain Gallery,0,320,0,0,403,385,376,1484
THE HAM BARBERS,0,0,390,352,345,367,0,1454
Star Print,328,383,201,343,198,0,0,1453
Hashi Japanese Restaurant,0,218,213,351,220,356,94,1452
The Albany Pub & Dining Room,0,69,101,110,333,639,189,1441
A&G Hairdressing,0,416,341,0,354,328,0,1439
Cakewalk Patisserie & Coffee House,0,195,223,172,297,289,263,1439
Black Radish Restaurant,0,0,254,283,385,516,0,1438
ORIENTAL PEARL (D),103,126,156,180,204,411,257,1437
Trattoria Calabrese,0,156,188,133,299,434,226,1436
Merton Park Dental,429,123,273,607,0,0,0,1432
Chesâ€™ Trattoria,256,239,384,319,107,127,0,1432
Lab375,0,0,395,679,0,351,0,1425
Johnâ€™s Barber Shop T/as John menâ€™s hairdesign,0,0,326,307,379,402,0,1414
Twickenham Pharmacy,310,246,183,333,304,38,0,1414
Chango Empanadas Wimbledon,8,10,60,174,312,371,475,1410
First Aid Home PC,335,0,366,417,291,0,0,1409
Brand Architekts,0,319,738,351,0,0,0,1408
The Oak,22,122,109,108,263,533,249,1406
The Financial Planning Group,0,218,606,580,0,0,0,1404
Wimbledon Pilates,343,348,475,0,236,0,0,1402
St Pauls Community Centre,70,223,208,353,61,171,310,1396
The Entertainer,145,133,178,196,176,565,0,1393
Tudor Drive Library,441,304,0,439,209,0,0,1393
Bengal Brasserie,159,147,114,140,358,388,84,1390
Diamond Valet Detailing,195,401,214,167,238,168,0,1383
The Wok Express,249,0,211,0,340,344,237,1381
"Tsaretta Spice, Twickenham",0,104,131,132,297,484,231,1379
Iris Hay Homeopathy,350,422,0,221,385,0,0,1378
Natterjacks,247,215,0,0,0,511,384,1357
Moksha,0,103,171,152,285,398,246,1355
Ariana Dry Cleaners,216,267,274,382,210,0,0,1349
Crystal Breeze (By Appointments only ),120,120,250,497,120,120,120,1347
The Fun Factory,0,380,223,0,314,424,0,1341
TW2 The Green,0,105,98,0,344,604,184,1335
Kingston Town Children's Centre,164,172,234,290,470,0,0,1330
"Dr Patton and Partners, Park Road Surgery",193,405,355,155,218,0,0,1326
Canela Cafe,0,0,0,135,174,460,554,1323
Sidra - Teddington,165,205,220,280,190,256,0,1316
Little Mumbai,139,89,168,140,378,394,0,1308
Stevens Tyres,196,220,192,301,399,0,0,1308
Simply Dental,143,62,201,505,253,139,0,1303
Light House,96,114,95,171,303,313,208,1300
The Pilates Clinic London Ltd,218,182,263,125,384,126,0,1298
HoMe Chinese Restaurant,110,212,265,265,167,278,0,1297
BallarÃ²,0,103,150,105,294,403,235,1290
Istanbul Barbecue TEDDINGTON,153,120,189,214,250,171,179,1276
Norbiton Sandwich Shop,247,173,230,290,333,0,0,1273
The Bridgelink Centre,88,148,481,189,169,151,39,1265
LJ Motorcycle Repairs Ltd,370,414,0,459,0,0,0,1243
Tattoo Studio 149,359,0,0,538,342,0,0,1239
Squireâ€™s Aquatic Centre,132,81,118,119,134,301,348,1233
The Cochin - Twickenham,0,93,115,97,244,494,184,1227
St Margarets Wines,0,140,164,0,552,368,0,1224
Whole Harmony Wellbeing Centre,192,242,207,191,386,0,0,1218
The RM2 Partnership Limited,0,211,724,281,0,0,0,1216
Perio and Implant Dental Referral Centre,0,260,390,235,330,0,0,1215
Richardson Evans Memorial Playing Fields,75,119,116,60,98,450,296,1214
Aquanaut Scuba & Snorkelling Centre,205,0,255,0,288,463,0,1211
Premier Wine,0,274,319,0,363,252,0,1208
Prem Indian Restaurant,53,83,126,160,324,379,83,1208
All Things Pilates,244,224,436,0,0,304,0,1208
Dance Addiction Studios,366,286,0,0,554,0,0,1206
England Rugby,145,480,358,83,130,0,0,1196
By The Bridge,37,8,38,96,64,385,565,1193
Absolute Return Partners LLP,300,345,0,545,0,0,0,1190
Elegant Stitch Pro Tailoring & Alterations,210,0,180,205,200,395,0,1190
SATORi Kitchens - Kingston Hill,0,306,0,0,328,273,282,1189
Kingston upon Thames & Surbiton Delivery Office,206,225,236,145,204,135,36,1187
Wimbledon Tandoori,96,72,34,168,279,418,119,1186
"Crossway, St Stephen's Church",245,181,192,353,215,0,0,1186
Vetech Motor Services,362,486,0,324,0,0,0,1172
Twickenham Training Centre,162,260,233,422,90,0,0,1167
The Focus Hall,360,190,38,71,299,134,69,1161
Batterfly,101,127,177,187,324,241,0,1157
Fuel Deli & Coffee,242,186,250,270,186,23,0,1157
Casa Mia,0,119,132,95,153,441,204,1144
Sai Restaurant,0,103,127,62,280,387,176,1135
Putney Osteopaths,149,424,346,212,0,0,0,1131
Able Physiotherapy,159,318,274,177,199,0,0,1127
Kumon Maths & English,0,252,292,196,0,384,0,1124
Burnell Avenue Play Space,75,75,88,160,54,501,166,1119
Riverside Drive Playground,247,224,198,243,190,0,0,1102
Old Wimbledonians & Donhead Sports Ground,36,40,104,55,64,493,291,1083
Teddington Fish Bar,0,126,126,240,280,270,0,1042
The Wimbledon Synagogue,79,91,189,149,165,368,0,1041
De Lissa Building,151,343,132,400,0,0,0,1026
Hons Chinese Takeaway,0,0,138,121,375,198,168,1000
Hampton Hill Theatre,108,117,128,128,27,492,0,1000
RICARDO'S,107,130,60,119,126,368,88,998
Molton Brown Kingston,152,0,158,0,0,467,219,996
St Margarets Catholic Church,171,137,358,225,103,0,0,994
Kingston Community Furniture,0,343,254,209,88,99,0,993
The Six Restaurant - Hampton Court,0,0,130,0,184,339,338,991
Regans,0,120,147,127,298,285,0,977
World Rugby Museum & Twickenham Stadium Tours,0,202,169,49,58,465,30,973
Le Petit Nantais,0,0,181,179,146,306,148,960
Jade's,0,0,230,0,300,160,265,955
Cave Shisha,220,280,228,0,220,0,0,948
The Hive,0,278,343,314,0,0,0,935
Base,205,382,110,109,122,0,0,928
Roehampton Base,205,382,110,109,122,0,0,928
Cod Upon Thames,0,208,0,216,192,280,0,896
Hanbeet Church Mission,73,49,144,64,0,0,565,895
Caffe Del Mare,0,0,96,117,312,352,0,877
"Sacred Heart RC Church, Teddington",59,57,45,57,174,68,397,857
Sheesh Mahal,25,11,45,48,275,403,42,849
Le Salon PrivÃ©,0,116,86,104,174,357,0,837
Hansons London Auction Centre,259,0,0,172,398,0,0,829
UK Fireworks,0,0,0,358,141,328,0,827
The Shack 68,10,8,15,24,115,644,10,826
A Cena,0,28,65,107,169,352,0,721
Paddock Allotments & Leisure Gardens,31,63,40,66,40,96,373,709
Day Lewis Pharmacy Twickenham,195,197,0,295,0,0,0,687
Barrecore Wimbledon Village,197,221,178,0,89,0,0,685
"Saint Agatha's Catholic Church, Kingston upon Thames",15,52,127,27,39,36,285,581
"Putney Dental Care ""Dental Matters Ltd""",87,278,86,74,0,0,0,525
The Scrummery,33,55,30,77,63,239,26,523
Emmanuel Church of England,63,24,128,32,264,0,0,511
Cornerstone Church Kingston - The Hub,134,33,60,21,40,0,179,467
London Full Gospel Church Mission Centre,0,6,0,23,26,0,404,459
"Holy Trinity Church, Roehampton",189,33,10,22,112,0,0,366
Swiss Bread Bakery and CafÃ©,0,345,0,0,0,0,0,345
Kingston Muslim Association,16,11,17,13,198,26,28,309
